0 0 0 0 0 0 0 0 0 0 0 0 0 0 0 0 0 0 0 0 0 0 0 0 0 0 0 0 0 0
0 1 1 1 0 2 2 2 2 0 0 0 1 1 1 0 2 2 2 2 0 1 1 1 0 2 2 2 2 0
0 1 3 3 3 3 3 3 1 0 0 0 1 3 3 3 3 3 3 1 0 1 3 3 3 3 3 3 1 0
0 1 3 0 0 0 0 3 1 0 0 0 1 3 0 0 0 0 3 1 0 1 3 0 0 0 0 3 1 0
0 1 3 0 3 3 0 3 1 0 0 0 1 3 0 3 3 0 3 1 0 1 3 0 3 3 0 3 1 0
0 1 3 0 3 3 0 3 1 0 0 0 1 3 0 3 3 0 3 1 0 1 3 0 3 3 0 3 1 0
0 1 3 3 3 3 3 3 1 0 0 0 1 3 3 3 3 3 3 1 0 1 3 3 3 3 3 3 1 0
0 1 1 1 1 1 1 1 1 0 0 0 1 1 1 1 1 1 1 1 0 1 1 1 1 1 1 1 1 0
0 0 0 0 0 0 0 0 0 0 0 0 0 0 0 0 0 0 0 0 0 0 0 0 0 0 0 0 0 0
0 0 0 0 0 0 0 0 0 0 0 0 0 0 0 0 0 0 0 0 0 0 0 0 0 0 0 0 0 0
0 1 1 1 0 2 2 2 2 0 0 0 1 1 1 0 2 2 2 2 0 1 1 1 0 2 2 2 2 0
0 1 3 3 3 3 3 3 1 0 0 0 1 3 3 3 3 3 3 1 0 1 3 3 3 3 3 3 1 0
0 1 3 0 0 0 0 3 1 0 0 0 1 3 0 0 0 0 3 1 0 1 3 0 0 0 0 3 1 0
0 1 3 0 3 3 0 3 1 0 0 0 1 3 0 3 3 0 3 1 0 1 3 0 3 3 0 3 1 0
0 1 3 0 3 3 0 3 1 0 0 0 1 3 0 3 3 0 3 1 0 1 3 0 3 3 0 3 1 0
0 1 3 3 3 3 3 3 1 0 0 0 1 3 3 3 3 3 4 4 4444444444444444444
0 1 1 1 1 1 1 1 1 0 0 0 1 1 1 1 1 1 1 1 0 1 1 1 1 1 1 1 1 0
0 0 0 0 0 0 0 0 0 0 0 0 0 0 0 0 0 0 0 0 0 0 0 0 0 0 0 0 0 0
0 0 0 0 0 0 0 0 0 0 0 0 0 0 0 0 0 0 0 0 0 0 0 0 0 0 0 0 0 0
