9 9 9 9 9 9 9 9 9 5 3 5 4 5 5 5 5 7 8 8 8 8 8 8 8 8 8 8 8 8 8 8
9 9 9 0 9 9 9 0 5 3 0 4 0 6 7 5 5 0 8 17 17 17 17 17 17 9 17 17 17 17 17 8
9 9 9 0 0 9 9 5 3 4 0 7 6 7 0 5 5 0 15 17 17 17 17 17 17 9 17 17 17 17 17 8
9 9 0 0 0 4 3 3 3 7 7 6 0 0 5 5 5 5 15 17 17 17 17 17 17 17 17 17 17 17 17 8
9 9 0 0 3 3 3 6 6 6 5 5 5 9 9 9 9 9 15 17 17 17 17 17 17 9 17 17 17 17 17 8
9 0 0 4 3 0 0 5 5 9 9 9 9 9 9 9 9 9 8 17 17 17 17 17 17 9 17 17 17 17 17 8
0 0 4 3 6 5 4 4 3 3 4 0 9 9 9 9 9 9 8 8 8 8 8 8 8 8 17 17 17 17 17 8
0 0 3 3 0 5 4 4 4 3 3 3 3 3 3 9 9 9 9 0 0 0 0 0 0 15 17 17 17 17 17 8
0 5 3 6 6 6 5 5 5 5 5 5 0 5 5 5 5 4 0 4 5 5 5 5 7 15 17 17 17 17 17 8
0 3 3 7 7 5 5 5 9 5 5 5 5 6 5 6 5 5 5 5 6 5 5 4 0 8 17 17 17 17 17 8
0 3 6 5 5 4 4 9 9 3 3 4 6 7 5 7 4 4 4 3 9 9 9 9 9 8 8 15 15 15 8 8
0 3 6 5 4 3 9 9 9 9 0 4 7 0 5 0 4 3 9 9 9 9 9 9 9 9 0 0 7 0 9 9
0 3 6 5 3 9 9 9 9 9 0 4 6 0 5 4 3 9 9 9 9 9 9 9 9 9 4 4 7 5 9 9
0 3 6 3 9 9 9 9 9 9 0 4 6 0 3 3 9 9 9 9 9 9 9 9 9 9 0 4 4 5 9 9
0 3 6 3 0 9 9 9 9 9 9 0 4 6 3 9 9 9 9 9 9 9 9 9 9 0 0 4 4 5 9 9
0 3 6 3 0 9 9 9 9 9 9 0 4 5 4 0 9 9 9 9 9 9 9 0 0 0 0 4 4 5 9 9
0 0 7 5 0 9 9 9 9 9 9 0 4 7 0 0 9 9 9 9 9 9 0 0 0 0 0 0 4 5 3 9
8 8 15 15 8 8 8 8 8 8 8 8 15 15 8 8 8 9 9 9 0 0 0 0 0 0 5 4 3 5 4 9
8 17 17 17 17 17 17 17 9 17 17 17 17 17 17 17 8 0 4 0 5 0 5 5 5 4 4 4 3 5 4 3
8 17 17 17 17 17 17 17 9 17 17 17 17 17 17 17 15 6 5 4 4 4 0 4 4 4 3 3 0 5 4 3
8 17 17 17 17 17 17 17 9 17 17 17 17 17 17 17 15 7 6 6 6 4 4 4 0 5 3 3 4 5 4 3
8 17 17 17 17 17 17 17 9 17 17 17 17 17 17 17 8 0 0 5 5 5 0 5 5 0 9 9 4 5 4 3
8 17 17 17 17 17 17 17 9 17 17 17 17 17 17 17 8 9 9 9 9 9 5 5 0 9 9 3 4 5 4 3
8 17 17 17 17 17 17 17 9 17 17 17 17 17 17 17 8 9 9 9 9 9 9 9 9 9 9 3 4 6 4 0
8 17 17 17 17 17 17 17 17 17 17 17 17 17 17 17 8 9 9 9 9 9 9 9 0 3 3 3 4 6 4 3
8 17 17 17 17 17 17 17 17 17 17 17 17 17 17 17 8 9 9 9 9 9 3 3 3 3 4 4 4 6 0 3
8 17 17 17 9 9 9 9 9 9 9 9 9 9 9 9 8 9 9 9 4 4 4 4 4 4 0 0 6 7 5 3
8 17 17 17 17 17 17 17 17 17 17 17 17 17 17 17 8 4 4 0 6 6 6 6 6 6 6 5 5 5 4 3
8 17 17 17 17 17 17 17 17 17 17 17 17 17 17 17 15 7 5 5 5 7 5 5 5 5 5 0 0 4 4 3
8 17 17 17 17 17 17 17 17 17 17 17 17 17 17 17 15 4 4 4 4 4 4 3 3 3 3 3 3 3 3 0
8 17 17 17 17 17 17 17 17 17 17 17 17 17 17 17 8 9 9 0 0 0 0 0 0 0 0 0 0 9 9 9
8 8 8 8 8 8 8 8 8 8 8 8 8 8 8 8 8 9 9 9 9 9 9 0 0 9 9 9 9 9 9 9
