0 0 0 0 0 0 0 0 0 0 0 0 19 19 19 19 19 19 19 19 19 0 0 0 0 0 0 0 0 0 0 0
0 0 0 0 0 0 0 0 0 0 0 0 19 19 19 19 19 19 19 19 19 0 0 0 0 0 0 0 0 0 0 0
0 0 0 0 0 0 0 0 0 0 0 0 0 19 19 19 19 19 19 19 0 0 0 0 0 0 0 0 0 0 0 0
0 0 0 0 0 0 0 0 0 0 0 0 0 19 19 19 19 19 19 19 20 0 0 0 0 0 0 0 0 0 0 0
0 0 17 17 17 17 0 0 0 0 0 0 0 19 19 19 19 19 19 19 20 0 0 0 17 17 17 17 0 0 0 0
0 17 17 0 0 17 17 0 0 0 0 0 0 20 19 19 19 19 19 19 20 0 0 17 17 0 0 17 17 0 0 0
0 17 0 0 0 0 17 0 0 0 0 0 0 0 20 20 19 19 19 20 0 0 0 17 0 0 0 0 17 0 0 0
0 17 0 0 0 0 17 0 0 0 0 0 0 0 0 20 19 20 19 20 0 0 0 17 0 0 0 0 17 0 0 0
0 17 17 0 0 17 17 0 0 0 0 0 0 0 0 0 20 19 19 0 0 0 0 17 17 0 0 17 17 0 0 0
0 0 17 0 0 17 0 0 0 0 0 0 0 0 0 0 20 19 0 0 0 0 0 0 17 0 0 17 0 0 0 10
0 0 0 0 0 0 0 0 0 0 0 17 17 0 0 0 0 0 0 0 0 0 0 0 0 0 0 0 0 0 0 10
0 0 0 0 0 0 0 0 0 0 0 0 17 0 0 0 0 0 0 0 0 0 0 0 0 0 0 0 0 0 10 10
0 0 0 0 0 0 0 0 0 0 0 0 17 0 0 0 0 0 17 17 0 0 0 0 0 0 0 0 0 0 10 10
0 0 0 0 0 0 0 0 0 0 0 17 17 0 0 0 0 0 17 0 0 0 0 0 0 0 0 0 0 0 10 10
0 14 14 0 0 0 0 0 0 0 0 0 0 0 0 0 0 0 17 0 0 0 0 0 0 0 0 0 0 0 10 10
10 14 14 0 0 0 0 0 0 0 0 0 0 0 0 0 0 0 17 17 0 0 0 0 0 0 0 0 0 10 10 10
10 14 14 10 10 10 10 10 10 0 0 0 0 0 0 0 0 0 0 0 0 0 0 0 0 0 0 0 0 10 10 10
10 14 14 10 10 10 10 10 10 10 10 0 0 0 0 17 17 0 0 0 0 0 0 0 0 0 0 0 0 10 10 10
10 14 14 10 10 10 10 10 10 10 10 10 10 10 0 17 17 0 0 0 0 0 0 0 0 0 0 0 10 10 10 10
0 14 14 0 10 10 10 10 10 10 10 10 10 10 10 10 0 0 0 0 0 0 0 0 0 14 14 10 10 10 10 10
0 0 0 0 0 0 0 0 0 0 0 10 10 10 10 10 10 10 10 10 10 10 10 10 10 14 14 10 10 10 10 10
0 0 0 0 0 0 0 0 0 0 0 0 10 10 10 10 10 10 10 10 10 10 10 10 10 14 14 10 10 10 10 10
0 0 0 0 0 0 0 0 0 0 0 0 0 0 10 10 10 10 10 10 10 10 10 10 10 14 14 10 10 10 10 10
0 0 0 0 0 0 0 0 0 0 27 0 17 17 17 17 17 15 15 15 15 0 0 0 0 14 14 0 10 10 10 10
0 0 0 0 0 0 0 27 0 0 0 0 17 17 0 0 0 0 0 15 15 0 27 0 0 0 0 0 10 10 10 10
0 0 0 0 0 0 0 0 0 0 0 0 17 0 0 0 0 0 0 0 15 0 0 0 0 0 0 0 0 10 10 10
0 0 0 0 0 0 0 0 0 27 0 0 16 0 0 0 17 0 0 0 16 0 0 0 0 0 0 0 0 0 10 10
0 0 0 0 0 0 0 0 0 0 0 0 16 0 0 0 17 0 0 0 16 0 27 0 0 0 27 0 0 0 0 10
0 0 0 0 0 0 27 0 0 0 0 0 16 0 0 0 17 0 0 0 16 0 0 0 0 0 0 0 0 0 0 0
0 0 0 0 0 0 0 0 0 0 0 0 17 0 0 0 0 0 0 0 17 0 0 0 0 0 0 0 0 0 0 0
0 0 0 0 0 0 0 0 0 0 0 0 17 17 0 0 0 0 0 17 17 0 0 0 0 0 0 0 0 0 0 0
0 0 0 0 0 0 0 0 0 0 0 0 17 17 17 17 17 17 17 17 17 0 0 0 0 0 0 0 0 0 0 0
