0 0 0 0 0 0 0 0 0 0 0 0 0 0 0 0 0 0 0 0 0 0 0 0 0 0 0 0 0 0 0 0
0 0 0 0 0 0 0 0 0 0 0 0 0 0 0 0 0 0 0 0 0 0 0 0 0 0 0 0 0 0 0 0
0 0 0 0 0 0 0 0 0 0 0 0 0 0 0 0 0 0 0 0 0 0 0 0 0 0 0 0 0 0 0 0
0 0 0 0 0 0 0 0 0 0 0 0 0 0 0 0 0 0 0 0 0 0 0 0 0 0 0 0 0 0 0 0
0 0 0 0 8 8 8 8 8 8 16 16 16 8 8 8 8 8 8 8 8 0 0 0 8 8 8 8 8 8 8 0
0 0 0 0 8 17 17 17 17 17 17 17 17 17 17 17 17 17 17 17 8 0 0 0 8 17 17 17 17 17 8 0
0 0 0 0 8 17 17 17 17 17 17 17 17 17 17 17 17 17 17 17 8 0 0 0 8 17 17 17 17 17 8 0
0 0 0 0 8 17 17 17 17 17 17 17 17 17 17 17 17 17 17 17 8 0 0 0 8 17 17 17 17 17 8 0
0 0 0 0 8 17 17 17 17 17 17 17 17 17 17 17 17 17 17 17 8 0 0 0 8 17 17 17 17 17 8 0
0 0 0 0 8 17 17 17 17 17 17 17 17 17 17 17 17 17 17 17 8 0 0 0 8 17 17 17 17 17 8 0
9 9 9 9 8 8 16 16 16 8 8 8 8 8 8 8 16 16 16 8 8 9 9 9 8 8 16 16 16 8 8 0
0 0 0 0 0 0 17 17 17 0 0 0 0 0 0 0 17 17 17 0 0 0 0 0 0 0 17 17 17 0 0 21
0 0 0 0 0 21 17 17 17 21 21 21 21 21 21 21 17 17 17 0 0 0 0 0 0 0 17 17 17 21 21 21
21 21 21 21 21 21 17 17 17 10 10 10 10 10 10 10 17 17 17 21 21 21 21 21 21 21 17 17 17 10 10 10
21 21 10 10 10 10 17 17 17 10 10 10 10 10 10 10 17 17 17 10 21 21 21 21 21 10 17 17 17 10 10 10
10 10 10 10 10 10 17 17 17 10 10 10 10 10 10 10 17 17 17 10 10 10 10 10 10 10 17 17 17 10 10 10
10 10 10 10 10 10 17 17 17 10 21 21 21 21 10 10 17 17 17 10 10 10 10 10 10 10 17 17 17 10 10 21
10 10 10 10 21 21 17 17 17 21 21 21 21 21 21 21 17 17 17 10 10 10 10 10 10 10 17 17 17 21 21 21
21 21 21 21 21 21 17 17 17 0 0 0 0 0 0 0 17 17 17 21 21 21 21 21 21 21 17 17 17 0 0 0
9 9 9 9 8 8 16 16 16 8 8 9 9 9 8 8 16 16 16 8 8 8 8 8 8 8 16 16 16 8 8 0
0 0 0 0 8 17 17 17 17 17 8 0 0 0 8 17 17 17 17 17 17 17 17 17 17 17 17 17 17 17 8 0
0 0 0 0 8 17 17 17 17 17 8 0 0 0 8 17 17 17 17 17 17 17 17 17 17 17 17 17 17 17 8 0
0 0 0 0 8 17 17 17 17 17 8 0 0 0 8 17 17 17 17 17 17 17 17 17 17 17 17 17 17 17 8 0
0 0 0 0 8 17 17 17 17 17 8 0 0 0 8 17 17 17 17 17 17 17 17 17 17 17 17 17 17 17 8 0
0 0 0 0 8 17 17 17 17 17 8 0 0 0 8 17 17 17 17 17 17 17 17 17 17 17 17 17 17 17 8 0
0 0 0 0 8 8 8 8 8 8 8 0 0 0 8 8 8 8 8 8 8 16 16 16 8 8 8 8 8 8 8 0
0 0 0 0 0 0 0 0 0 0 0 0 0 0 0 0 0 0 0 0 0 0 0 0 0 0 0 0 0 0 0 0
0 0 0 0 0 0 0 0 0 0 0 0 0 0 0 0 0 0 0 0 0 0 0 0 0 0 0 0 0 0 0 0
0 0 0 0 0 0 0 0 0 0 0 0 0 0 0 0 0 0 0 0 0 0 0 0 0 0 0 0 0 0 0 0
0 0 0 0 0 0 0 0 0 0 0 0 0 0 0 0 0 0 0 0 0 0 0 0 0 0 0 0 0 0 0 0
0 0 0 0 0 0 0 0 0 0 0 0 0 0 0 0 0 0 0 0 0 0 0 0 0 0 0 0 0 0 0 0
0 0 0 0 0 0 0 0 0 0 0 0 0 0 0 0 0 0 0 0 0 0 0 0 0 0 0 0 0 0 0 0
