9 9 9 9 9 9 9 9 9 9 9 9 9 9 9 9 9 9 9 9 9 9 9 9 9 8 8 8 8 8 8 8
9 21 21 21 21 21 21 21 21 21 21 21 21 21 21 21 21 21 21 21 21 21 21 21 21 8 17 17 17 17 17 8
9 21 21 21 21 21 21 21 21 21 21 9 21 9 21 21 9 21 21 9 21 21 9 21 21 8 17 17 17 17 17 8
9 21 21 21 21 21 21 21 9 21 21 9 21 21 21 21 9 21 21 21 9 21 21 21 21 8 17 17 17 17 17 8
9 21 27 21 21 21 27 21 9 21 8 8 8 8 8 8 8 8 8 21 21 21 21 21 21 8 17 17 17 17 17 8
9 21 21 21 21 21 21 21 9 21 8 17 17 17 17 17 17 17 8 21 21 9 21 21 21 8 17 17 17 17 17 8
9 21 21 21 21 21 21 21 9 21 15 17 17 17 17 17 17 17 15 21 21 9 9 9 9 8 8 15 15 8 8 8
9 21 21 21 27 21 21 21 9 21 8 17 17 17 17 17 17 17 8 21 21 9 17 17 17 17 17 17 17 9 9 9
9 21 21 21 21 21 21 27 9 21 8 8 8 8 15 15 8 8 8 21 21 9 17 17 17 17 17 17 17 9 9 9
9 21 27 21 21 21 21 21 21 21 21 21 21 21 17 17 21 21 21 21 21 9 17 17 9 9 9 27 9 9 9 9
9 21 21 21 21 21 21 21 21 21 21 21 21 21 17 17 9 9 9 9 9 9 17 17 9 27 21 21 21 21 21 9
9 21 21 21 21 21 21 21 9 9 9 9 9 9 17 17 21 21 21 21 21 21 17 17 9 21 21 21 21 21 21 9
9 21 21 21 21 21 21 27 9 17 17 17 17 17 17 17 17 17 17 17 17 21 17 17 9 21 21 27 21 27 21 9
9 21 9 9 9 9 9 9 9 17 21 21 21 17 17 17 17 21 21 21 17 21 17 17 9 21 21 21 21 21 21 9
9 21 21 21 27 17 17 17 17 17 21 10 21 17 17 17 17 21 10 21 17 17 17 17 9 21 21 21 21 21 21 9
9 21 21 21 21 17 17 17 17 17 21 21 21 17 17 17 17 21 21 21 17 17 17 17 9 21 21 21 21 21 21 9
9 21 21 21 21 17 17 9 21 17 17 17 17 17 17 17 17 17 17 8 8 8 15 15 8 8 8 21 21 21 21 9
9 21 21 21 27 17 17 9 21 21 9 9 9 21 21 9 21 21 21 8 17 17 17 17 17 17 8 21 21 21 21 9
9 21 21 21 21 17 17 9 21 21 21 21 21 21 21 9 21 27 21 8 17 17 17 17 17 17 8 21 21 21 21 9
9 21 21 21 21 17 17 9 21 21 9 9 9 21 21 9 9 21 21 8 17 17 17 17 17 17 8 21 21 21 21 9
9 21 21 21 21 17 17 9 21 21 21 21 21 21 21 9 9 21 21 8 17 17 17 17 17 17 8 21 21 27 27 9
9 21 21 21 21 17 17 9 21 21 21 21 21 21 21 9 9 21 21 15 17 17 17 17 17 17 8 21 27 21 21 9
9 21 21 8 8 15 15 8 8 21 21 21 21 21 21 21 21 21 21 15 17 17 17 17 17 17 8 21 21 21 27 9
9 21 21 8 17 17 17 17 8 21 21 21 27 21 27 21 21 21 21 8 17 17 17 17 17 17 8 21 21 21 21 9
9 21 21 8 17 17 17 17 8 21 21 21 21 27 21 21 21 21 21 8 17 17 17 17 17 17 15 21 21 21 21 9
9 21 21 8 17 17 17 17 8 21 21 21 21 21 21 27 21 21 21 8 8 8 8 8 8 15 15 21 21 21 21 9
9 21 21 8 8 8 8 8 8 21 21 9 21 21 21 21 21 21 21 21 21 21 21 21 21 21 21 21 21 21 21 9
9 21 21 21 21 21 9 21 21 21 21 21 21 21 21 9 21 21 21 21 21 9 9 21 21 21 21 21 21 21 21 9
9 21 21 21 21 21 9 21 21 21 9 21 21 21 21 9 21 21 21 21 21 9 9 9 21 21 21 21 27 21 21 9
9 21 21 21 21 21 9 21 21 21 9 21 21 9 21 21 21 21 21 21 9 9 9 9 21 21 21 21 21 21 21 9
9 21 21 21 21 32 9 21 21 21 9 21 21 21 21 21 21 21 21 21 21 21 21 21 21 21 21 21 21 21 21 9
9 9 9 9 9 9 9 9 9 9 9 9 9 9 9 9 9 9 9 9 9 9 9 9 9 9 9 9 9 9 9 9
