2 3 4 5 5 5 6 5 5 4 3 2 0 0 0 0 4 4 4 4 4 4 9 0 0 0 0 9 0 0 0 0
2 3 4 5 6 6 6 6 5 9 3 2 0 0 0 0 4 9 5 5 5 5 9 0 0 0 0 0 0 0 9 0
2 3 4 5 6 6 7 6 5 9 3 2 0 0 0 0 4 9 5 5 5 9 9 0 9 9 9 9 9 0 9 0
2 3 4 5 6 7 7 6 5 9 3 2 0 0 0 0 4 9 6 6 9 0 0 0 9 0 0 0 0 0 9 0
2 3 4 5 6 7 7 6 5 9 3 0 0 0 0 0 4 9 6 7 9 0 0 0 9 0 0 0 9 0 9 0
2 3 4 5 6 6 6 6 5 9 9 9 9 9 9 9 9 9 6 6 9 0 0 0 9 0 0 0 0 0 9 9
0 9 4 5 5 5 5 5 5 4 3 2 0 0 0 0 4 5 5 5 9 9 9 0 0 9 9 9 9 0 0 0
0 0 9 9 0 0 9 9 9 9 9 9 9 9 9 9 9 9 5 5 5 5 4 0 9 3 3 4 3 0 0 0
0 0 0 9 9 0 9 3 4 5 6 6 6 6 5 4 3 4 4 4 4 4 4 9 3 3 9 5 4 3 9 0
0 0 0 0 0 0 9 3 9 5 6 7 7 6 5 4 9 9 9 0 9 0 9 3 3 4 5 6 5 4 3 3
0 9 0 0 0 0 9 3 4 9 6 7 6 5 5 4 3 0 0 0 0 0 9 3 4 5 9 7 9 5 9 3
0 0 9 9 9 0 9 3 4 5 9 6 9 5 5 9 3 0 0 9 9 0 9 3 4 5 9 7 7 6 5 4
0 0 0 0 0 0 9 3 4 9 4 4 4 9 4 9 3 0 0 0 9 0 9 3 4 5 6 7 7 6 5 4
0 0 0 0 0 0 9 3 3 9 3 3 3 9 3 9 9 9 0 0 9 0 9 3 4 5 9 7 9 9 9 4
0 0 0 0 0 0 9 0 0 9 0 0 0 9 4 5 6 7 9 0 0 0 0 9 9 9 9 7 6 5 4 3
0 0 9 9 9 9 9 0 0 9 0 0 0 9 4 5 6 6 9 9 0 0 9 3 4 5 6 6 6 5 4 3
0 0 0 0 0 0 9 0 0 9 0 0 0 3 4 5 9 5 0 0 0 9 0 3 4 5 5 9 9 5 9 3
0 0 0 0 0 0 9 0 0 9 9 9 9 3 4 4 4 4 9 0 9 0 0 3 9 4 4 4 4 4 4 3
0 0 0 9 0 0 9 0 0 0 0 0 0 3 3 9 3 3 9 0 0 0 0 3 3 9 3 9 3 3 9 3
9 0 0 0 0 0 0 9 0 0 0 0 0 9 0 0 0 0 9 0 0 0 0 0 0 0 9 0 0 0 0 0
0 9 0 0 0 9 0 0 9 0 0 0 0 0 9 0 0 0 9 0 0 9 0 0 0 0 0 0 0 0 0 0
0 0 9 0 0 0 0 0 0 0 0 0 0 0 0 9 0 0 0 0 3 3 9 9 9 9 9 9 9 9 0 0
0 0 0 9 0 0 0 0 9 0 0 0 0 0 0 0 9 0 0 9 4 4 4 4 4 4 4 4 3 0 0 0
0 0 0 0 9 0 0 9 4 4 9 9 0 9 9 0 0 9 0 3 9 5 5 5 9 9 5 4 3 0 9 0
0 0 0 0 0 0 9 5 5 5 4 3 0 0 0 0 0 0 9 3 4 9 9 9 9 6 5 4 3 0 0 0
0 0 0 0 0 0 9 6 6 5 4 3 0 0 0 0 0 0 0 9 4 5 6 7 7 6 5 4 9 9 0 0
0 0 0 9 0 0 9 7 6 5 4 9 9 9 9 9 0 0 0 3 9 5 6 7 7 6 5 4 9 0 0 0
0 0 0 0 0 0 9 6 6 5 4 9 0 0 0 0 0 0 0 3 4 5 6 6 6 6 5 9 3 0 0 0
9 9 9 0 0 0 9 5 5 5 4 9 0 0 0 0 0 0 0 3 4 5 9 5 5 5 9 4 3 0 9 0
0 0 9 9 0 0 9 4 9 9 4 9 0 0 0 9 9 9 0 3 9 4 9 4 4 4 4 4 3 0 0 0
0 0 0 0 0 0 3 3 3 3 3 3 9 0 9 0 0 0 0 3 3 3 9 9 9 9 9 3 3 0 0 0
0 0 0 0 0 0 2 2 2 2 0 0 0 0 0 0 0 0 0 0 0 0 0 0 0 0 0 0 0 0 0 0
