0 0 0 0 0 0 0 0 0 0 0 0 0 0 0 0 0 0 0 0 0 0 0 0 0 0 0 0 0 0 0 0
0 17 0 0 0 0 0 0 0 0 0 0 0 0 0 0 0 0 0 0 0 0 0 0 0 0 0 0 0 0 0 0
0 0 15 15 15 8 8 8 8 8 8 8 8 8 8 8 0 0 8 8 8 8 8 8 8 8 8 15 15 15 0 0
0 0 15 17 17 17 17 17 17 17 17 17 17 17 17 8 0 0 8 17 17 17 17 17 17 17 17 17 17 15 0 0
0 0 15 17 17 17 17 17 17 17 17 17 17 17 17 8 0 0 8 17 17 17 17 17 17 17 17 17 17 15 0 0
0 0 8 17 17 17 17 17 17 17 17 17 17 17 17 8 0 0 8 17 17 17 17 17 17 17 17 17 17 8 0 0
0 0 8 17 17 17 17 17 17 17 17 17 17 17 17 8 0 0 8 17 17 17 17 17 17 17 17 17 17 8 0 0
0 0 8 17 17 17 17 9 9 9 17 17 17 17 17 15 0 0 15 17 17 17 17 9 9 9 17 17 17 8 0 0
0 0 8 17 17 17 17 9 9 9 17 17 17 17 17 15 0 0 15 17 17 17 17 9 9 9 17 17 17 8 0 0
0 0 8 17 17 17 17 9 9 9 17 17 17 17 17 15 0 0 15 17 17 17 17 9 9 9 17 17 17 8 0 0
0 0 8 17 17 17 17 17 17 17 17 17 17 17 17 8 0 0 8 17 17 17 17 17 17 17 17 17 17 8 0 0
0 0 8 17 17 17 17 17 17 17 17 17 17 17 17 8 0 0 8 17 17 17 17 17 17 17 17 17 17 8 0 0
0 0 8 17 17 17 17 17 17 17 17 17 17 17 17 8 0 0 8 17 17 17 17 17 17 17 17 17 17 8 0 0
0 0 8 17 17 17 17 17 17 17 17 17 17 17 17 8 0 0 8 17 17 17 17 17 17 17 17 17 17 8 0 0
0 0 8 8 8 8 8 15 15 15 8 8 8 8 8 8 0 0 8 8 8 8 8 15 15 15 8 8 8 8 0 0
0 0 0 0 0 0 0 0 0 0 0 0 0 0 0 0 0 0 0 0 0 0 0 0 0 0 0 0 0 0 0 0
0 0 0 0 0 0 0 0 0 0 0 0 0 0 0 0 0 0 0 0 0 0 0 0 0 0 0 0 0 0 0 0
0 0 8 8 8 8 8 15 15 15 8 8 8 8 8 0 0 8 8 8 8 8 8 15 15 15 8 8 8 8 0 0
0 0 8 17 17 17 17 17 17 17 17 17 17 17 8 0 0 8 17 17 17 17 17 17 17 17 17 17 17 8 0 0
0 0 8 17 17 17 17 17 17 17 17 17 17 17 8 0 0 8 17 17 17 17 17 17 17 17 17 17 17 8 0 0
0 0 8 17 17 17 17 17 17 17 17 17 17 17 8 0 0 8 17 17 17 17 17 17 17 17 17 17 17 8 0 0
0 0 8 17 17 17 17 17 17 17 17 17 17 17 8 0 0 8 17 17 17 17 17 17 17 17 17 17 17 8 0 0
0 0 8 17 17 17 17 9 9 9 17 17 17 17 15 0 0 15 17 17 17 17 9 9 9 17 17 17 17 8 0 0
0 0 8 17 17 17 17 9 9 9 17 17 17 17 15 0 0 15 17 17 17 17 9 9 9 17 17 17 17 8 0 0
0 0 8 17 17 17 17 9 9 9 17 17 17 17 15 0 0 15 17 17 17 17 9 9 9 17 17 17 17 8 0 0
0 0 8 17 17 17 17 17 17 17 17 17 17 17 8 0 0 8 17 17 17 17 17 17 17 17 17 17 17 8 0 0
0 0 8 17 17 17 17 17 17 17 17 17 17 17 8 0 0 8 17 17 17 17 17 17 17 17 17 17 17 8 0 0
0 0 15 17 17 17 17 17 17 17 17 17 17 17 8 0 0 8 17 17 17 17 17 17 17 17 17 17 17 15 0 0
0 0 15 17 17 17 17 17 17 17 17 17 17 17 8 0 0 8 17 17 17 17 17 17 17 17 17 17 17 15 0 0
0 0 15 15 15 8 8 8 8 8 8 8 8 8 8 0 0 8 8 8 8 8 8 8 8 8 8 15 15 15 0 0
0 0 0 0 0 0 0 0 0 0 0 0 0 0 0 0 0 0 0 0 0 0 0 0 0 0 0 0 0 0 0 0
0 0 0 0 0 0 0 0 0 0 0 0 0 0 0 0 0 0 0 0 0 0 0 0 0 0 0 0 0 0 0 0
