9 9 9 9 9 9 9 9 9 9 9 9 9 9 9 9 9 9 9 9 9 9 9 9 9 9 9 9 9 9 9 9
9 10 10 10 10 10 10 10 10 10 21 21 21 21 9 21 21 21 21 21 9 21 10 10 10 9 21 9 21 21 21 9
9 10 10 10 10 10 10 10 10 10 21 9 21 21 9 21 21 21 21 21 21 21 10 10 10 9 21 9 21 21 21 9
9 9 21 21 10 10 10 10 10 10 21 21 21 21 9 21 21 21 21 21 9 21 10 10 10 10 21 21 21 21 21 9
9 21 21 21 21 10 10 10 10 10 10 10 9 21 9 9 9 21 21 21 9 21 10 10 10 10 10 21 9 9 21 9
9 21 9 21 9 10 10 10 10 10 10 10 10 10 10 10 10 10 10 21 21 10 10 10 10 10 21 21 21 21 21 9
9 21 21 21 21 21 21 10 10 10 10 10 10 10 10 10 10 10 10 10 9 9 9 21 17 17 17 21 10 9 9 9
9 21 21 21 21 21 21 17 17 17 17 17 17 21 17 17 17 17 17 21 21 9 9 21 21 10 10 10 10 10 10 9
9 10 10 21 21 21 21 21 21 10 10 10 10 10 10 10 10 10 21 21 21 10 10 21 17 10 10 10 10 10 10 9
9 10 10 10 21 17 21 21 21 10 10 10 10 10 10 10 21 21 9 21 10 10 10 10 17 10 10 10 10 10 10 9
9 10 10 10 10 17 21 21 21 21 10 10 10 10 10 10 21 21 21 17 10 10 10 10 17 10 10 10 10 10 10 9
9 10 10 10 10 17 10 10 21 21 10 10 10 10 10 10 21 21 21 17 10 10 10 10 17 21 10 10 10 10 10 9
9 10 21 10 21 17 10 10 10 10 10 10 12 10 10 10 10 10 10 17 10 10 10 10 21 21 21 10 10 10 10 9
9 10 10 21 21 21 10 10 10 10 12 12 12 12 10 10 10 10 10 17 10 10 10 10 9 21 21 21 9 9 9 9
9 10 10 21 21 10 10 12 12 12 12 12 12 12 12 10 10 10 10 17 9 9 17 17 17 17 17 21 21 21 21 9
9 10 10 17 17 10 10 10 12 12 12 21 32 12 12 12 12 12 10 21 21 21 21 10 10 10 21 21 21 21 21 9
9 10 10 17 17 10 10 10 10 10 12 21 21 12 12 12 12 12 10 9 17 17 9 10 10 10 10 21 21 21 21 9
9 10 10 17 17 10 10 10 10 10 12 12 12 12 12 10 10 10 10 9 17 17 9 10 10 10 10 10 10 9 21 9
9 10 10 17 17 10 21 21 10 10 10 12 12 12 10 10 10 10 10 9 17 17 9 10 10 10 10 10 10 21 21 9
9 10 10 17 17 21 21 21 17 17 10 10 10 10 10 10 10 21 21 21 17 17 21 21 10 10 10 10 10 21 9 9
9 21 21 21 21 21 10 10 17 17 21 21 10 10 10 10 21 21 8 8 15 15 8 8 21 10 10 10 10 21 21 9
9 9 21 9 21 21 10 10 10 10 21 21 17 17 17 21 21 21 8 17 17 17 17 8 21 10 10 10 10 21 21 9
9 21 21 21 21 10 10 10 10 10 10 10 10 10 21 21 21 21 8 17 17 17 17 8 21 10 10 10 10 21 21 9
9 21 21 21 10 10 10 10 10 10 10 10 10 10 10 10 21 21 8 17 17 17 17 8 21 10 10 10 10 10 21 9
9 21 21 21 17 17 17 17 21 10 10 10 10 10 10 10 10 21 8 8 8 8 8 8 21 21 10 10 21 21 21 9
9 10 10 17 10 10 10 21 21 9 21 10 10 10 10 10 10 21 21 21 21 21 21 21 9 21 21 10 21 21 21 9
9 10 10 17 10 10 10 21 21 21 21 21 10 10 10 10 10 10 10 10 10 10 10 21 21 21 21 21 21 21 21 9
9 10 10 17 10 10 10 21 10 10 21 21 10 10 10 10 10 10 10 10 10 10 10 10 10 21 21 21 21 21 21 9
9 21 21 21 21 10 10 10 10 10 21 21 10 10 10 10 10 10 10 10 10 10 10 10 21 9 21 9 9 21 21 9
9 21 21 21 9 10 10 10 10 10 21 21 21 10 10 10 10 10 10 10 10 10 10 21 21 21 21 9 21 21 21 9
9 21 21 21 9 10 10 10 10 10 21 21 21 21 21 21 21 21 21 21 21 21 21 21 21 21 21 9 21 21 21 9
9 9 9 9 9 9 9 9 9 9 9 9 9 9 9 9 9 9 9 9 9 9 9 9 9 9 9 9 9 9 9 9
