8 8 8 8 8 9 9 9 9 9 9 9 9 9 9 9 9 9 9 9 9 9 9 9 9 9 9 9 9 9 9 9
8 17 17 17 8 9 0 0 0 0 0 9 9 0 0 9 9 0 0 9 9 9 9 9 0 0 0 0 0 0 0 9
8 17 17 17 8 9 0 0 0 0 0 9 9 0 0 9 9 0 0 9 9 9 9 9 0 0 0 0 0 0 0 9
8 17 17 17 8 9 0 0 9 0 0 0 0 0 0 0 0 0 0 0 0 0 0 9 9 9 9 9 0 0 0 9
8 8 15 8 8 9 0 0 9 0 0 0 0 0 0 0 0 0 0 0 0 0 0 9 9 9 9 9 0 0 0 9
9 0 0 0 9 9 0 0 9 0 0 9 9 9 9 9 9 9 9 9 9 0 0 9 0 0 0 0 0 0 0 9
9 0 0 0 9 9 0 0 9 0 0 9 9 9 9 9 9 9 9 9 9 0 0 0 0 0 0 0 0 0 0 9
9 0 0 0 9 9 0 0 9 0 0 0 0 0 0 0 0 0 0 9 9 0 0 0 0 0 9 9 0 0 0 9
9 0 0 0 9 9 0 0 9 0 0 0 0 0 0 0 0 0 0 9 9 0 0 9 9 9 9 9 0 0 0 9
9 0 0 0 9 9 9 9 9 0 0 9 9 9 9 9 9 9 9 9 9 0 0 9 0 0 0 0 0 0 0 9
9 0 0 0 9 9 9 9 9 0 0 9 9 9 9 9 9 9 9 9 9 0 0 9 0 0 0 0 0 0 0 9
9 0 0 0 0 0 0 0 0 0 0 9 9 0 0 0 0 0 0 9 9 0 0 9 0 0 9 9 0 0 0 9
9 0 0 0 0 0 0 0 0 0 0 9 9 0 0 0 0 0 0 9 9 0 0 9 0 0 9 9 0 0 0 9
9 0 0 0 9 9 0 0 9 9 9 9 9 0 0 9 9 0 0 9 9 0 0 9 0 0 9 9 0 0 0 9
9 0 0 0 9 9 0 0 9 9 9 9 9 0 0 9 9 0 0 9 9 0 0 9 0 0 9 9 0 0 0 9
9 0 0 0 9 9 0 0 0 0 0 9 9 0 0 9 9 0 0 9 9 0 0 9 0 0 9 9 0 0 0 9
9 0 0 0 9 9 0 0 0 0 0 9 9 0 0 9 9 0 0 9 9 0 0 9 9 9 9 9 0 0 0 9
9 0 0 0 9 9 9 9 9 9 9 9 9 0 0 9 9 0 0 0 0 0 0 0 0 0 9 9 0 0 0 9
9 0 0 0 9 9 9 9 9 9 9 9 9 0 0 9 9 0 0 0 0 0 0 0 0 0 9 9 0 0 0 9
9 0 0 0 0 0 0 0 0 0 0 0 0 0 0 9 9 0 0 9 9 9 9 9 9 9 9 9 0 0 0 9
9 0 0 0 0 0 0 0 0 0 0 0 0 0 0 9 9 0 0 9 9 9 9 9 9 9 9 9 0 0 0 9
9 9 9 9 9 9 9 9 9 0 0 9 9 9 9 9 9 0 0 9 9 0 0 0 0 0 9 9 0 0 0 9
9 9 9 9 9 9 9 9 9 0 0 9 9 9 9 9 9 0 0 9 9 0 0 0 0 0 9 9 0 0 0 9
9 0 0 0 0 0 0 0 0 0 0 9 9 0 0 0 0 0 0 9 9 9 9 9 0 0 9 9 0 0 0 9
9 0 0 0 0 0 0 0 0 0 0 9 9 0 0 0 0 0 0 9 9 9 9 9 0 0 9 9 0 0 0 9
9 0 0 9 9 9 9 9 9 0 0 9 9 0 0 9 9 0 0 9 9 0 0 9 0 0 9 9 0 0 0 9
9 0 0 9 0 0 0 0 0 0 0 9 9 0 0 9 9 0 0 9 9 0 0 9 0 0 9 9 0 0 0 9
9 0 0 9 0 0 0 0 0 0 0 9 9 0 0 9 9 0 0 9 9 0 0 9 0 0 9 8 8 15 8 8
9 0 0 9 9 9 9 9 9 9 9 9 9 0 0 9 9 0 0 9 9 0 0 9 0 0 9 8 17 17 17 8
9 0 0 0 0 0 0 0 0 0 0 0 0 0 0 9 9 0 0 0 0 0 0 0 0 0 9 8 17 17 17 8
9 0 0 0 0 0 0 0 0 0 0 0 0 0 0 9 9 0 0 0 0 0 0 0 0 0 9 8 17 17 17 8
9 9 9 9 9 9 9 9 9 9 9 9 9 9 9 9 9 9 9 9 9 9 9 9 9 9 9 8 8 8 8 8
