10 10 10 10 10 10 10 10 10 10 10 10 10 10 10 10 10 10 10 10 10 10 10 10 10 10 10 10 10 10 10 10
10 10 10 10 10 10 10 10 10 10 10 10 10 10 10 10 10 10 10 10 10 10 10 10 10 10 10 10 10 10 10 10
10 10 10 10 10 10 10 10 10 10 10 10 10 10 10 10 10 21 21 10 10 10 21 21 10 10 10 21 10 10 10 21
21 21 21 10 10 10 10 10 21 21 10 10 10 10 10 10 10 21 21 21 10 10 21 21 21 10 21 21 21 21 21 21
21 21 21 21 10 10 10 21 21 10 21 10 10 10 10 10 10 10 21 21 10 21 10 21 10 10 21 21 21 21 21 21
21 21 21 21 21 10 10 21 21 10 10 21 10 10 10 21 21 10 21 10 10 21 10 10 10 10 21 21 21 21 21 21
0 0 21 21 21 10 10 10 10 21 10 21 21 10 10 21 21 10 10 10 21 21 10 10 10 21 21 21 21 21 21 21
0 0 0 0 21 21 10 10 10 10 21 21 21 10 10 21 21 10 10 10 21 21 10 10 10 21 21 21 21 0 0 0
8 8 8 8 8 0 21 10 10 21 21 21 21 21 10 21 10 10 10 21 21 10 10 10 10 21 21 21 0 0 27 0
8 17 17 17 8 0 21 21 10 10 21 21 21 10 10 21 10 10 10 21 21 10 10 10 21 21 21 0 0 0 0 0
8 17 17 17 8 0 21 21 10 10 21 21 21 10 10 21 10 10 10 21 10 10 10 21 21 0 0 0 0 0 0 0
8 17 17 17 8 0 0 21 10 10 10 21 21 10 10 10 10 10 21 10 10 10 21 21 0 0 0 0 0 0 0 0
8 8 15 8 8 0 0 21 21 10 10 21 21 21 10 10 10 10 10 10 10 21 21 21 0 0 0 0 0 0 0 0
0 0 0 0 0 0 0 0 21 21 10 21 10 21 10 10 10 10 10 10 21 21 21 0 0 0 27 0 0 27 0 0
0 0 0 0 0 0 0 0 0 21 10 10 10 10 10 10 10 10 10 21 21 0 0 0 0 0 0 0 0 0 0 0
0 0 0 0 0 0 0 0 0 21 21 10 10 10 10 10 10 10 21 21 0 0 0 0 0 0 0 0 0 0 0 0
27 0 0 0 0 8 8 8 8 8 21 10 10 10 10 10 21 21 21 8 8 8 8 8 0 27 0 0 0 0 0 0
0 0 0 0 0 8 17 17 17 8 21 21 10 10 10 10 10 21 21 8 17 17 17 8 0 0 0 0 0 0 27 0
0 0 0 0 0 15 17 17 17 15 0 17 17 17 17 17 17 17 21 15 17 17 17 15 0 0 0 0 0 0 0 0
0 0 0 0 0 15 17 17 17 15 0 17 17 17 17 17 17 17 21 15 17 17 17 15 0 0 0 0 0 0 0 0
0 0 0 0 0 15 17 17 17 15 0 17 17 17 17 17 17 17 21 15 17 17 17 15 0 0 0 0 0 0 0 0
0 0 0 27 0 8 17 17 17 8 0 21 10 10 10 10 10 21 21 8 17 17 17 8 0 0 0 0 0 0 0 0
0 0 0 0 0 8 8 8 8 8 0 21 10 10 10 10 10 21 21 8 8 8 8 8 0 0 0 0 0 0 0 0
0 0 0 0 0 0 0 0 0 0 0 21 21 10 10 10 10 21 21 0 0 0 0 0 0 0 8 8 15 8 8 0
0 0 0 0 0 27 0 0 0 0 0 21 10 10 10 10 10 21 21 0 0 0 0 0 0 0 8 17 17 17 8 0
27 0 0 0 0 0 0 0 27 0 0 21 21 10 10 10 10 21 21 0 0 27 0 27 0 0 8 17 17 17 8 0
0 0 0 0 0 0 0 0 0 0 0 21 10 10 10 10 10 21 21 21 0 0 0 0 0 0 8 17 17 17 8 0
0 0 0 0 0 0 0 0 0 0 0 21 21 10 10 10 10 10 21 0 0 0 0 0 0 0 8 8 8 8 8 0
0 0 0 0 0 0 0 0 0 0 0 21 21 10 10 10 10 10 21 21 0 0 0 0 0 0 0 0 0 0 0 0
0 0 0 0 0 0 0 0 0 0 0 21 10 10 10 10 10 10 21 0 0 0 0 0 0 0 0 0 0 0 0 0
0 0 0 0 0 0 0 0 0 0 0 0 21 10 10 10 10 10 21 0 0 0 0 0 0 0 0 0 0 0 0 0
0 0 0 0 0 0 0 0 0 0 0 0 21 21 10 10 10 10 21 21 0 0 0 0 0 0 0 0 0 0 0 0
