10 10 10 0 0 0 0 0 0 0 0 17 17 17 17 0 0 26 26 0 26 26 26 26 26 26 26 26 26 26 26 26
10 10 10 10 0 14 0 0 0 0 0 14 14 14 14 0 0 0 0 26 26 26 26 26 26 26 26 26 26 26 26 26
10 10 10 10 14 14 14 0 0 0 0 14 14 14 17 26 0 26 26 26 26 26 26 26 26 26 26 26 26 26 26 26
0 0 10 14 14 14 10 10 10 10 0 17 17 17 17 26 0 26 0 26 26 26 26 26 26 26 26 26 26 26 26 26
0 0 14 14 14 10 10 10 10 10 10 10 22 10 22 0 26 0 26 26 26 26 26 26 26 26 26 26 26 26 26 26
0 0 0 14 0 10 10 10 10 10 10 10 10 10 10 22 22 0 26 26 26 26 26 26 26 26 26 26 26 26 26 26
0 0 0 0 0 0 9 0 0 0 10 10 22 10 22 10 22 22 22 26 26 26 26 26 26 26 26 26 26 26 26 26
0 0 0 0 0 0 0 0 0 0 0 0 0 10 22 22 22 22 22 22 22 22 22 22 22 22 26 26 26 26 26 26
0 0 0 0 0 0 17 17 17 17 0 0 0 26 26 18 22 22 22 22 22 22 22 22 22 22 22 22 22 22 22 22
0 0 0 0 0 0 14 14 14 17 0 0 26 0 0 18 18 18 22 22 22 22 22 22 22 22 22 22 22 22 22 22
0 0 0 0 0 0 14 14 14 17 0 26 18 26 26 18 18 18 26 26 26 22 22 22 26 22 22 22 22 22 22 22
0 0 0 0 0 0 17 17 17 17 0 18 18 18 26 0 26 18 26 26 26 26 26 26 26 26 26 22 22 22 22 22
0 0 0 0 0 0 0 0 0 26 26 18 18 18 18 26 26 26 26 26 26 26 26 26 26 26 26 26 26 26 26 26
0 0 0 0 0 0 0 0 0 0 0 26 18 0 26 26 26 18 26 26 26 26 16 26 26 26 26 26 16 26 26 26
0 17 14 14 17 0 0 26 26 0 0 0 26 26 26 26 18 18 18 26 26 16 16 16 26 26 26 16 16 16 26 26
0 17 14 14 17 0 0 0 0 18 18 0 26 0 26 26 18 18 18 26 26 26 26 26 26 26 26 26 26 26 26 26
0 17 14 14 17 0 0 0 18 18 18 18 26 0 26 26 18 18 26 26 26 26 26 26 26 26 26 26 26 26 26 26
0 17 17 17 17 0 0 0 18 18 18 26 0 26 26 26 26 26 26 26 26 26 26 26 26 16 16 26 26 26 26 26
0 0 0 0 0 0 0 0 18 18 18 0 26 26 26 26 26 26 26 26 26 26 26 26 16 16 16 16 26 26 26 26
0 0 0 0 0 0 0 18 18 18 26 0 26 26 26 26 26 16 16 26 26 26 26 16 16 14 14 16 16 26 26 26
0 0 0 0 0 0 0 0 26 0 0 0 26 26 26 26 16 16 16 16 26 26 26 16 16 14 14 16 16 26 26 26
0 0 0 0 0 0 0 26 0 0 26 0 26 26 26 16 16 14 14 16 16 26 26 26 16 14 14 16 26 26 26 26
0 0 0 0 0 0 0 0 0 26 0 26 26 26 26 16 16 14 14 14 14 26 26 26 26 14 14 26 26 26 26 26
0 0 0 0 0 0 0 0 0 26 18 26 26 26 26 26 16 16 16 14 26 26 26 26 26 26 26 26 26 26 26 26
0 0 0 0 0 0 0 0 18 18 18 18 26 26 26 26 26 16 16 26 26 26 26 26 26 26 26 26 26 26 26 26
0 0 0 0 0 0 0 26 18 18 18 18 0 26 26 26 26 26 26 26 26 26 26 26 26 26 26 26 26 26 26 26
0 0 0 0 0 0 0 0 26 18 18 0 26 26 26 26 26 26 26 26 16 14 26 26 26 26 26 26 26 26 26 26
0 0 0 0 0 0 0 0 0 0 26 26 26 26 26 26 26 26 26 16 16 14 14 26 26 26 26 26 26 26 26 26
0 0 0 0 0 0 0 0 26 26 26 26 26 26 26 26 26 26 16 16 14 14 16 16 26 26 26 26 26 26 26 26
0 0 0 0 0 0 26 0 0 0 26 26 26 26 26 26 26 26 16 16 14 14 16 16 26 26 26 26 26 26 26 26
0 0 0 0 0 0 0 0 26 0 26 26 26 26 26 26 26 26 26 16 16 16 16 26 26 26 26 26 26 26 26 26
0 0 0 0 0 0 0 0 0 26 0 0 26 26 26 26 26 26 26 26 16 16 26 26 26 26 26 26 26 26 26 26
