8 8 8 8 8 8 8 7 7 7 7 7 7 7 7 7 27 7 7 7 7 7 7 7 7 7 7 7 7 27 7 7
8 17 17 17 17 17 8 7 7 27 7 7 27 7 7 7 27 7 7 7 7 7 7 7 7 7 7 7 7 7 27 7
8 17 17 17 17 17 8 7 7 7 7 7 7 7 7 7 7 7 7 15 15 8 8 8 8 8 8 8 8 7 7 7
8 17 17 17 17 17 8 7 7 7 7 7 7 7 7 7 7 7 7 15 17 17 17 17 17 17 17 17 8 7 7 7
8 17 17 17 17 17 8 7 27 7 7 7 7 7 7 7 7 7 7 8 17 17 17 17 17 17 17 17 8 7 7 7
8 8 15 15 8 8 8 7 7 7 12 12 12 7 7 7 7 7 7 8 17 17 17 17 17 17 17 17 8 7 7 7
7 7 7 7 7 7 7 7 7 7 12 12 12 12 7 7 7 7 7 8 17 17 17 17 17 17 17 17 8 7 7 7
7 7 7 7 7 7 7 7 7 12 12 12 12 12 12 7 12 12 7 8 8 17 17 17 17 17 17 17 8 27 27 7
7 27 7 7 7 7 7 7 12 12 12 12 12 12 12 12 12 12 7 7 8 8 17 17 17 17 17 17 8 7 7 7
7 7 7 27 7 27 7 7 7 12 12 12 12 12 12 12 12 7 7 7 7 8 8 8 8 8 15 15 8 27 7 7
7 27 7 7 7 7 7 7 7 7 12 12 12 12 12 12 7 7 7 7 7 7 7 7 7 7 7 7 7 27 7 7
7 7 7 7 7 7 7 7 7 7 7 7 12 12 12 12 7 7 7 27 7 27 7 7 7 7 27 7 7 7 7 7
7 7 7 7 7 7 7 7 7 7 7 7 12 12 7 7 27 7 7 7 7 7 7 7 7 7 7 7 7 7 7 7
7 27 7 7 27 7 7 27 7 7 7 7 12 12 7 7 7 27 7 7 7 7 7 7 7 7 7 7 7 7 7 7
7 7 7 7 7 7 7 7 7 27 7 7 12 12 12 7 7 7 7 7 7 27 7 7 7 8 15 15 8 7 7 7
7 7 7 7 7 7 7 7 27 7 7 7 12 12 12 7 7 7 7 7 7 7 7 7 8 8 17 17 8 27 27 7
7 27 7 7 27 7 7 7 7 7 7 7 7 12 12 12 12 12 7 7 7 7 7 8 8 17 17 17 8 7 7 7
7 7 7 7 7 7 7 7 7 7 7 7 7 7 7 12 12 12 7 7 27 7 8 8 17 17 17 17 8 7 7 7
7 7 7 7 7 27 7 7 7 7 7 27 7 7 7 12 12 12 12 7 7 7 8 17 17 17 17 17 8 7 7 7
7 7 7 7 7 7 7 7 7 7 7 7 7 7 7 7 12 12 12 7 7 7 8 17 17 17 17 17 8 27 7 7
7 7 7 7 7 7 7 7 7 7 7 7 7 7 7 7 7 12 12 7 7 7 8 17 17 17 17 17 8 7 7 7
7 27 7 7 7 7 7 7 7 7 7 7 27 7 7 7 7 12 12 7 7 7 8 17 17 17 17 17 8 7 7 7
7 7 7 7 8 8 8 8 8 8 8 7 7 7 27 7 7 12 12 7 7 7 15 17 17 17 17 17 8 7 27 7
7 7 7 7 15 17 17 17 17 17 8 7 7 7 7 7 7 12 12 7 7 7 15 15 8 8 8 8 8 7 7 7
27 7 7 8 8 17 17 17 17 17 8 7 7 7 7 7 7 12 12 7 27 7 7 7 7 7 7 7 7 7 7 7
7 7 8 8 17 17 17 17 17 17 8 7 7 7 7 7 7 12 12 7 7 7 7 7 7 7 7 7 7 7 7 7
7 7 8 17 17 17 17 17 17 17 15 7 27 7 7 17 17 17 17 17 17 7 7 7 27 7 7 27 7 27 7 27
7 7 8 17 17 17 17 17 17 17 15 7 7 7 7 17 17 17 17 17 17 7 7 7 27 7 7 7 7 7 7 7
7 27 8 8 17 17 17 17 17 17 8 7 7 7 7 7 7 12 12 7 7 7 7 27 7 7 7 7 7 7 27 7
27 7 7 8 15 8 17 17 17 17 8 7 7 7 27 7 7 12 12 7 27 7 7 7 7 7 7 7 7 7 7 7
7 7 7 7 7 8 8 8 8 8 8 7 7 7 7 7 7 12 12 7 7 7 7 7 7 7 7 7 7 7 7 7
7 7 7 7 7 7 7 7 7 7 7 7 7 7 7 7 7 12 12 7 7 7 7 7 7 7 7 7 7 7 7 7
