0 0 0 0 0 0 0 0 0 0 0 0 9 0 0 0 0 0 0 0 0 0 0 0 0 0 0 0 0 0 0 0
0 8 8 8 8 8 0 0 0 0 0 9 9 9 0 0 0 0 0 0 0 0 0 0 0 0 21 21 21 21 21 21
0 8 17 17 17 8 0 0 0 0 0 0 9 0 0 0 0 0 0 0 0 0 21 21 21 21 10 10 10 10 10 10
0 8 17 17 17 8 0 0 9 0 0 0 0 0 0 0 0 0 0 0 17 21 21 10 10 10 10 10 10 10 10 10
0 8 17 17 17 15 0 9 9 9 0 0 0 9 0 0 0 0 0 17 17 17 10 10 10 10 10 10 10 10 10 10
0 8 8 8 15 15 0 0 9 0 0 0 9 9 9 0 0 0 0 21 17 17 17 10 10 10 10 10 10 21 21 21
0 0 0 0 0 0 0 0 0 0 0 0 0 9 0 0 0 0 21 21 10 17 17 17 10 10 21 21 21 21 21 21
0 0 0 0 9 0 0 0 9 0 0 0 0 0 0 0 0 21 21 10 10 10 17 17 17 21 21 21 21 0 0 0
0 0 0 9 9 9 0 9 9 9 0 0 9 0 0 0 0 21 10 10 10 10 10 17 17 17 0 0 0 0 0 0
9 0 0 0 9 0 0 0 9 0 0 9 9 9 0 0 0 21 10 10 10 10 10 21 17 0 0 0 0 0 0 0
9 9 0 0 0 0 0 0 0 0 0 0 9 0 0 0 21 21 10 10 10 10 21 0 0 0 0 0 0 0 0 0
9 0 0 0 0 0 0 0 9 0 0 0 0 0 0 0 21 21 10 10 10 21 0 0 0 0 0 0 0 0 0 0
0 0 0 0 9 0 0 9 9 9 0 0 0 0 0 0 21 21 10 10 10 21 0 0 0 0 0 0 0 0 0 0
0 0 0 9 9 9 0 0 9 0 0 0 0 9 0 0 21 17 10 10 10 21 0 0 0 0 0 0 0 0 0 0
0 0 0 0 9 0 0 0 0 0 0 0 9 9 9 0 17 17 17 10 10 21 0 0 0 9 0 0 0 0 0 9
0 0 0 0 0 0 0 0 0 0 0 0 0 9 0 0 21 17 17 17 10 21 0 0 9 9 9 0 0 0 9 9
0 9 0 0 0 0 0 9 0 0 0 0 0 0 0 0 21 10 17 17 17 21 0 0 0 9 0 0 0 0 0 9
9 9 9 0 0 0 9 9 9 0 0 0 0 0 0 21 21 10 10 17 17 17 0 0 0 0 0 0 9 0 0 0
0 9 0 0 0 0 0 9 0 0 0 0 0 0 21 21 10 10 10 10 17 17 17 0 0 0 0 9 9 9 0 0
0 0 0 0 0 0 0 0 0 0 0 0 21 21 10 10 10 10 10 10 21 17 0 0 0 0 0 0 9 0 0 0
0 0 0 0 0 0 0 0 0 0 17 21 10 10 10 10 10 10 10 10 21 0 0 0 0 0 0 0 0 0 0 0
0 0 0 0 0 0 0 0 21 17 17 17 10 10 10 10 10 10 10 21 0 0 9 0 0 0 9 0 0 0 0 0
0 0 0 0 0 0 0 21 21 21 17 17 17 10 10 10 10 21 21 21 0 9 9 9 0 9 9 9 0 0 9 0
0 0 0 0 0 0 0 21 21 10 10 17 17 17 10 21 21 21 21 0 0 0 9 0 0 0 9 0 0 9 9 9
0 0 0 0 0 0 21 21 10 10 10 10 17 17 17 21 21 0 0 0 0 0 0 0 0 0 0 0 0 0 9 0
0 0 0 0 0 21 21 10 10 10 10 10 10 17 17 17 0 0 0 0 0 0 0 9 0 0 0 0 0 0 0 0
0 0 0 0 0 21 21 10 10 10 10 10 21 0 17 0 0 0 0 0 0 0 9 9 9 0 15 15 8 8 8 0
0 0 0 0 0 21 21 10 10 10 10 21 21 0 0 0 0 0 9 0 0 0 0 9 0 0 15 17 17 17 8 0
0 0 0 0 21 21 10 10 10 10 21 21 0 0 0 0 0 9 9 9 0 0 0 0 0 0 8 17 17 17 8 0
0 0 0 0 21 21 10 10 10 10 21 0 0 0 0 0 0 0 9 0 0 0 9 0 0 0 8 17 17 17 8 0
0 0 0 0 21 21 10 10 10 10 21 0 0 0 0 0 0 0 0 0 0 9 9 9 0 0 8 8 8 8 8 0
0 0 0 0 21 21 10 10 10 21 21 0 0 0 0 0 0 0 0 0 0 0 9 0 0 0 0 0 0 0 0 0
