0 0 0 0 0 0 0 0 0 0 0 0 0 3 3 3 0 0 0 0 0 21 21 21 10 10 10 10 21 21 21 21
0 0 0 0 0 0 0 0 0 3 3 3 3 4 4 4 3 3 0 0 0 21 21 21 10 10 10 10 21 21 21 21
0 0 0 0 0 0 4 3 3 5 4 4 3 3 5 5 15 15 8 8 8 21 21 21 10 10 10 10 21 21 21 21
0 0 0 0 0 0 4 3 4 4 4 0 4 4 3 3 15 17 17 17 8 0 21 21 10 10 10 10 21 21 21 21
0 0 0 0 0 0 3 3 4 3 3 0 0 0 0 0 8 17 17 17 8 0 21 21 10 10 10 10 21 21 21 21
0 0 8 8 8 8 15 15 15 8 8 8 8 0 0 0 8 17 17 17 8 0 21 21 10 10 10 10 10 21 21 21
0 0 8 17 17 17 17 17 17 17 17 17 8 0 0 0 8 17 17 17 8 0 21 21 21 10 10 10 10 21 21 21
0 0 8 17 17 17 17 17 17 17 17 17 8 0 0 0 8 17 17 17 8 0 0 21 21 10 10 10 10 10 21 21
0 0 8 17 17 17 17 17 17 17 17 17 8 0 0 0 8 17 17 17 8 0 0 21 21 21 10 10 10 10 10 21
0 0 8 17 17 17 9 9 9 17 17 17 8 0 0 0 8 8 15 15 8 0 0 21 21 21 10 10 10 10 10 21
0 0 8 17 17 17 9 9 9 17 17 17 8 0 0 0 0 0 3 7 0 0 0 0 21 21 21 10 10 10 10 10
0 0 8 17 17 17 9 9 9 17 17 17 15 3 3 3 3 3 3 6 3 0 0 0 21 21 21 21 10 10 10 10
0 0 8 17 17 17 17 17 17 17 17 17 15 3 3 5 7 5 5 7 3 0 0 0 0 21 21 21 10 10 10 10
0 0 8 17 17 17 17 17 17 17 17 17 15 3 3 0 3 3 3 3 5 3 0 0 0 21 21 21 21 10 10 10
0 0 8 17 17 17 17 17 17 17 17 17 8 5 0 3 0 0 0 3 5 4 4 0 0 0 21 21 21 21 10 10
0 0 8 8 8 8 8 8 15 15 15 8 8 0 0 0 0 0 0 4 3 6 3 0 0 0 0 21 21 21 10 10
0 0 0 0 0 0 0 0 3 6 3 3 0 0 0 0 0 0 0 0 4 5 3 3 0 0 0 21 21 21 21 21
0 0 0 0 0 0 0 3 3 5 3 4 0 0 0 0 0 0 0 0 4 3 6 3 0 0 0 0 0 21 21 21
0 0 0 0 27 0 0 3 3 5 3 4 0 0 0 0 0 0 0 0 0 4 5 3 0 0 0 0 0 0 0 0
0 0 0 0 0 0 0 3 4 6 3 0 0 0 0 0 0 0 0 8 8 15 15 15 8 8 8 8 8 8 8 8
0 0 0 0 0 0 0 0 4 4 3 3 0 0 0 0 0 0 4 8 17 17 17 17 17 17 17 17 17 17 17 8
0 27 0 0 0 0 0 0 6 6 4 3 0 0 0 0 4 4 6 15 17 17 17 17 17 17 17 17 17 17 17 8
0 0 0 0 0 0 8 8 15 15 15 8 8 0 0 4 4 7 0 15 17 17 17 17 17 17 17 17 17 17 17 8
0 0 0 0 0 0 8 17 17 17 17 17 8 4 4 7 6 4 4 15 17 17 17 9 17 17 17 9 17 17 17 8
0 0 0 0 27 0 8 17 17 17 17 17 15 3 4 6 6 4 0 8 17 17 17 17 9 9 9 17 17 17 17 8
0 0 0 0 0 0 8 17 17 17 17 17 15 4 4 0 4 0 0 8 17 17 17 17 9 9 9 17 17 17 17 8
0 27 0 0 0 0 8 17 17 17 17 17 15 4 27 4 0 0 0 8 17 17 17 17 9 9 9 17 17 17 17 8
0 0 0 0 0 0 8 17 17 17 17 17 8 0 0 0 0 0 0 8 17 17 17 9 17 17 17 9 17 17 17 8
0 0 0 27 0 0 8 8 8 8 8 8 8 0 0 0 0 0 0 8 17 17 17 17 17 17 17 17 17 17 17 8
0 0 0 0 0 0 0 0 0 0 0 0 0 0 0 0 0 0 0 8 17 17 17 17 17 17 17 17 17 17 17 8
0 0 0 0 0 0 0 0 0 0 0 0 0 0 0 0 0 0 0 8 17 17 17 17 17 17 17 17 17 17 17 8
0 0 0 0 0 0 0 0 0 0 0 0 0 0 0 0 0 0 0 8 8 8 8 8 8 8 8 8 8 8 8 8
