17 17 17 17 17 17 17 17 17 17 17 17 17 17 17 17 17 17 17 17 17 17 17 17 17 17 17 17 17 17 17 17
17 17 9 17 9 17 17 17 17 17 17 17 17 17 17 17 17 17 17 17 17 17 17 17 17 17 17 17 17 17 17 17
17 17 8 15 8 8 8 8 8 15 15 8 8 8 8 8 8 8 8 8 8 8 8 8 8 8 8 8 17 17 17 17
17 17 8 17 17 17 17 17 17 17 17 8 17 17 17 17 17 17 17 17 9 17 17 9 17 17 17 8 9 17 17 17
17 17 8 9 17 17 17 17 9 17 9 8 17 9 17 17 17 9 17 17 17 17 17 17 17 17 17 8 17 17 17 17
17 17 8 17 17 17 17 17 17 17 17 8 17 9 9 17 17 17 9 17 17 9 9 9 9 17 17 15 17 17 17 17
17 17 8 17 17 17 17 17 17 17 17 8 17 17 9 17 9 17 17 9 17 17 17 17 9 17 17 15 17 17 17 17
17 9 8 17 17 17 17 17 17 17 17 8 17 17 17 17 9 17 17 17 9 17 17 17 9 17 9 8 17 17 17 17
17 17 15 17 9 17 17 17 17 17 9 15 17 17 9 17 9 17 17 17 17 9 17 17 9 17 17 8 9 17 17 17
17 17 15 17 9 17 17 17 9 17 17 15 17 17 9 17 9 9 9 9 17 17 9 17 17 17 17 8 17 17 17 17
17 17 15 17 9 17 17 17 17 17 9 15 17 17 9 17 17 17 17 17 17 17 17 9 17 17 17 8 17 17 17 17
17 9 8 17 17 17 17 17 17 17 17 8 17 17 17 17 17 9 17 9 17 17 17 17 9 17 17 8 17 17 17 17
17 17 8 17 17 17 17 17 17 17 17 8 9 17 9 17 9 17 17 9 17 17 17 9 17 9 17 8 17 17 17 17
17 17 8 17 17 17 17 17 17 17 17 8 17 17 9 17 17 9 17 9 17 17 9 17 17 17 17 8 17 17 17 17
17 17 8 17 17 9 17 9 17 17 17 8 17 17 9 17 17 17 17 17 17 9 17 17 17 17 17 8 17 17 17 17
17 17 8 8 8 8 15 8 8 8 8 8 17 17 9 9 9 9 9 9 17 17 17 9 17 17 9 8 9 17 17 17
17 17 8 17 17 17 17 9 17 17 17 8 9 17 17 17 17 17 9 17 17 17 17 17 17 9 17 8 17 17 17 17
17 17 8 17 9 17 17 17 17 17 17 8 17 17 9 17 9 17 17 17 9 17 17 17 17 17 17 15 17 17 17 17
17 17 8 17 9 9 9 9 9 17 17 8 17 17 17 17 9 17 17 17 9 17 17 17 17 17 17 15 17 17 17 17
17 17 8 17 17 17 17 17 9 17 17 8 8 8 15 15 8 8 8 8 8 8 8 8 15 15 8 8 17 17 17 17
17 17 8 17 9 17 17 17 17 17 8 8 17 9 17 17 9 17 17 17 8 17 17 9 17 17 9 8 9 17 17 17
17 17 8 17 17 17 17 17 17 8 8 17 17 17 17 17 17 17 17 9 8 9 17 17 17 17 17 8 17 17 17 17
17 17 8 8 8 8 15 8 8 8 17 17 17 9 17 17 17 9 17 17 15 17 17 17 17 17 17 8 17 17 17 17
17 17 8 17 17 17 17 17 17 8 17 17 17 17 9 17 9 17 17 9 8 17 17 9 9 17 17 8 17 17 17 17
17 17 8 17 17 9 17 17 17 8 17 17 17 17 17 32 17 17 17 9 8 17 17 9 9 17 17 8 17 17 17 17
17 17 8 17 17 9 17 17 17 15 17 9 17 17 9 17 9 17 17 17 15 17 17 17 17 17 9 8 9 17 17 17
17 9 8 17 17 9 9 9 17 8 17 17 17 9 17 17 17 9 17 9 8 9 17 17 17 17 17 15 17 17 17 17
17 17 15 17 17 17 17 17 17 8 17 17 17 17 17 17 17 17 17 17 8 17 17 9 17 17 17 8 9 17 17 17
17 17 15 15 8 8 8 8 8 8 8 8 8 8 8 8 8 8 8 8 8 15 15 8 8 8 8 8 17 17 17 17
17 17 17 17 9 17 17 17 17 17 17 17 17 17 17 17 17 17 17 17 9 17 17 9 17 17 17 17 17 17 17 17
17 17 17 17 17 17 17 17 17 17 17 17 17 17 17 17 17 17 17 17 17 17 17 17 17 17 17 17 17 17 17 17
17 17 17 17 17 17 17 17 17 17 17 17 17 17 17 17 17 17 17 17 17 17 17 17 17 17 17 17 17 17 17 17
