10 10 10 0 0 0 0 4 4 4 0 9 9 9 9 0 0 0 0 0 0 0 0 0 0 0 0 0 0 0 0 0
10 10 10 10 0 14 7 7 7 4 4 17 14 14 17 7 4 4 4 4 0 0 0 0 0 0 0 0 0 0 0 0
10 10 10 10 14 14 14 0 4 4 4 9 14 14 9 4 5 7 7 7 4 0 0 0 0 0 0 0 0 0 0 0
0 0 10 14 14 14 10 10 10 10 0 9 9 9 9 4 4 4 4 4 4 7 7 4 0 0 0 0 0 0 0 0
0 0 14 14 14 10 10 10 10 10 10 10 10 10 10 0 0 0 0 0 0 4 5 5 4 0 0 0 0 0 0 0
0 4 5 14 0 10 10 10 10 10 10 10 10 10 10 10 10 0 0 0 0 0 4 4 7 4 0 0 0 0 10 10
0 4 5 4 0 0 9 0 0 0 10 10 10 10 10 10 10 10 10 0 0 0 0 0 4 4 4 0 0 10 10 10
4 7 4 4 0 0 0 0 0 0 0 0 0 10 10 10 10 10 10 10 10 0 0 0 0 4 7 14 10 10 10 10
4 4 7 4 4 0 9 9 9 9 0 0 0 0 27 8 10 10 10 10 10 10 10 0 0 0 14 14 14 10 10 10
4 7 4 7 7 4 17 14 14 9 0 0 0 0 6 8 8 8 0 10 10 10 10 10 10 10 10 14 14 14 10 10
4 5 7 4 4 4 17 14 14 9 0 0 8 6 7 8 8 8 0 0 10 10 10 10 10 10 10 10 14 14 14 0
4 4 7 4 0 0 9 9 9 9 27 8 8 8 7 0 6 8 0 0 2 10 10 10 10 10 10 10 10 14 7 0
0 4 7 4 0 0 0 0 0 0 0 8 8 8 8 7 6 0 0 0 2 1 0 10 10 10 10 0 0 4 4 4
0 4 5 4 0 0 0 0 0 0 6 7 27 0 6 6 0 0 0 0 5 5 0 0 0 0 0 0 8 0 4 4
0 9 17 17 9 0 0 0 0 6 7 7 6 6 0 0 0 0 0 8 6 5 2 0 0 0 0 8 4 7 4 4
0 9 14 14 9 0 0 0 0 8 8 7 6 0 0 0 0 0 8 5 6 6 5 0 0 0 0 4 7 7 4 4
0 9 14 14 9 0 0 0 8 8 8 8 0 0 0 0 0 0 0 0 5 5 4 0 0 0 0 0 4 4 7 4
0 9 9 9 9 0 0 0 8 8 8 0 0 0 0 0 0 0 0 0 0 6 4 0 0 9 9 0 0 0 5 4
0 0 0 0 0 0 0 0 8 8 8 0 0 0 0 0 0 0 0 0 0 4 4 0 9 9 9 9 0 0 4 7
0 0 0 0 0 0 0 8 8 8 27 0 0 0 0 0 0 9 9 0 0 4 7 9 9 14 14 9 9 0 0 5
0 0 0 0 0 0 6 7 7 7 6 0 0 0 0 0 9 9 9 9 0 4 0 9 9 14 14 9 9 0 4 7
0 0 0 0 0 0 0 7 7 7 6 0 0 0 0 9 9 14 14 9 9 4 4 0 9 17 17 9 0 0 5 7
0 0 0 0 0 0 6 0 27 7 6 0 0 0 0 9 9 14 14 17 17 5 4 4 0 17 17 4 4 4 7 4
0 0 0 0 0 0 0 7 7 7 8 0 0 0 0 0 9 9 9 17 7 7 7 4 4 5 4 4 4 4 4 0
0 0 0 0 0 0 0 6 8 8 8 8 0 0 0 0 0 9 9 5 4 5 5 7 4 4 5 7 7 7 4 0
0 0 0 0 0 0 0 6 7 8 8 8 0 0 0 0 0 0 0 0 4 4 5 5 7 7 7 7 5 5 0 0
0 0 0 0 0 0 0 0 7 8 8 6 0 0 0 0 0 0 0 0 9 17 5 4 5 5 5 4 0 0 0 0
0 0 0 0 0 0 0 0 6 6 7 6 0 0 0 0 0 0 0 9 9 17 17 4 4 0 4 0 0 0 0 0
0 0 0 0 0 0 0 0 27 6 7 27 0 0 0 0 0 0 9 9 14 14 9 9 0 0 0 0 0 0 0 0
0 0 0 0 0 0 0 0 6 6 6 6 0 0 0 0 0 0 9 9 14 14 9 9 0 0 0 0 0 0 0 0
0 0 0 0 0 0 0 0 0 6 7 6 0 0 0 0 0 0 0 9 9 9 9 0 0 0 0 0 0 0 0 0
0 0 0 0 0 0 0 0 0 6 7 7 0 0 0 0 0 0 0 0 9 9 0 0 0 0 0 0 0 0 0 0
