9 21 21 21 21 21 21 21 21 21 21 21 21 9 21 9 21 21 21 21 21 21 21 21 21 8 8 8 8 8 8 8
21 21 21 21 21 21 21 21 9 21 21 21 21 21 21 21 21 21 21 9 21 21 21 21 21 8 17 17 17 17 17 8
21 21 21 21 21 21 9 9 9 9 21 9 21 9 21 21 9 21 21 9 21 21 9 21 21 8 17 17 17 17 17 8
8 15 15 8 8 8 8 21 21 21 21 9 21 21 21 21 9 21 21 21 9 21 21 21 21 8 17 17 17 17 17 8
8 17 17 17 17 17 8 21 9 21 8 8 8 8 8 8 8 8 8 21 21 9 21 21 21 8 17 17 17 17 17 8
8 17 17 17 17 17 8 21 9 21 8 17 17 17 17 17 17 17 8 21 21 9 21 21 21 15 17 17 17 17 17 8
8 17 17 17 17 17 8 21 9 21 15 17 17 17 17 17 17 17 15 21 21 9 9 9 9 15 15 8 8 8 8 8
8 17 17 17 17 17 8 21 9 21 8 17 17 17 17 17 17 17 8 21 21 9 17 17 17 17 17 17 17 9 21 21
8 17 17 17 17 17 8 21 9 21 8 8 8 8 15 15 8 8 8 21 21 9 17 17 17 17 17 17 17 9 21 21
8 17 17 17 17 17 15 21 21 21 21 21 21 21 17 17 21 21 21 21 21 9 17 17 9 9 9 21 9 9 21 21
8 8 8 8 8 15 15 21 9 21 21 21 21 21 17 17 9 9 9 9 9 9 17 17 9 21 21 21 21 21 21 21
21 21 21 21 21 21 21 21 9 9 9 9 9 9 17 17 10 10 10 10 10 10 17 17 9 21 21 21 21 21 21 21
21 21 21 21 21 21 21 21 9 17 17 17 17 17 17 17 17 17 17 17 17 10 17 17 9 21 21 9 21 21 9 21
21 21 9 9 21 9 9 9 9 17 10 10 10 21 21 21 21 10 10 10 17 10 17 17 9 9 9 9 21 21 9 9
21 21 21 21 21 17 17 17 17 17 10 10 10 21 21 21 21 10 10 10 17 17 17 17 21 21 21 21 21 21 21 21
21 9 21 21 21 17 17 17 17 17 10 10 10 21 21 21 21 10 10 10 17 17 17 17 21 21 21 21 21 21 21 21
21 9 21 21 21 17 17 9 21 21 21 21 21 21 21 21 21 21 21 8 15 8 8 8 8 8 9 21 21 21 21 21
21 9 21 21 21 17 17 9 21 21 9 9 9 21 21 9 21 21 21 8 17 17 17 17 17 8 21 21 21 21 21 21
21 9 9 9 21 17 17 9 21 21 21 21 21 21 21 9 21 27 21 8 17 17 17 17 17 8 21 21 21 21 21 21
21 21 21 21 21 17 17 9 21 21 9 9 9 21 21 9 9 21 21 8 17 17 17 17 17 8 21 21 8 15 15 8
21 21 9 9 21 17 17 9 21 21 21 21 21 21 21 21 21 21 21 8 17 17 17 17 17 8 21 21 8 17 17 8
21 9 21 21 21 17 17 9 21 21 21 21 21 21 21 9 9 21 21 8 17 17 17 17 17 8 21 21 8 17 17 8
21 9 21 8 8 15 15 8 8 21 9 21 21 9 21 21 21 21 21 8 17 17 17 17 17 8 21 21 8 17 17 8
21 9 21 8 17 17 17 17 8 21 9 21 21 21 9 21 21 21 21 8 17 17 17 17 17 8 21 21 8 15 15 8
21 21 21 8 17 17 17 17 8 21 9 21 21 21 21 9 21 9 21 15 17 17 17 17 17 15 21 21 21 21 21 21
21 21 9 8 17 17 17 17 8 21 21 21 21 21 21 9 21 9 21 15 15 8 8 8 8 8 21 21 21 21 21 21
21 21 21 8 8 8 8 8 8 21 21 9 21 21 21 21 21 9 21 21 21 21 21 21 21 9 21 21 21 21 21 21
21 21 9 9 21 21 9 21 21 21 21 21 21 21 21 9 21 9 21 21 21 9 21 21 21 21 21 21 21 21 21 21
21 21 9 21 21 21 9 21 21 21 9 21 21 21 21 9 21 9 21 21 21 9 9 21 21 9 9 9 21 9 21 9
21 21 9 21 21 21 9 21 21 21 9 21 21 9 21 21 21 21 21 21 17 21 21 21 21 21 21 21 21 21 21 21
21 21 21 21 21 32 9 21 21 21 9 21 21 21 21 9 9 9 9 21 21 21 21 21 21 21 21 21 21 21 21 21
21 21 21 21 21 21 21 21 21 21 21 21 21 21 21 21 21 21 21 21 21 21 21 21 21 21 21 21 21 21 21 21
