7 7 7 7 7 9 7 7 7 7 7 7 7 7 9 7 7 7 7 9 7 7 7 7 7 9 7 7 7 7 7 7
27 7 27 7 7 9 7 7 7 7 7 7 7 7 7 7 7 7 7 7 7 7 7 7 7 7 7 7 7 7 7 7
7 7 7 7 27 9 7 7 9 9 9 9 7 7 7 7 8 8 8 8 8 8 8 15 8 9 9 9 7 9 7 7
7 7 7 27 7 9 7 7 9 7 7 9 27 7 9 7 8 17 17 17 17 17 17 17 8 7 7 7 27 7 7 7
27 9 7 7 7 9 7 7 9 7 7 9 7 7 7 7 8 17 17 17 17 17 17 17 8 7 27 7 7 9 9 7
7 7 7 7 7 9 7 9 7 7 7 9 7 7 7 7 15 17 17 17 17 17 17 17 8 7 7 7 7 9 7 7
7 7 9 7 7 9 7 9 7 7 7 9 7 7 7 7 15 17 17 17 17 17 17 17 8 9 7 9 7 7 27 7
7 7 7 9 7 9 7 7 9 7 7 9 7 7 7 7 8 17 17 17 17 17 17 17 15 7 7 7 7 7 7 7
7 9 7 7 7 7 9 7 7 9 7 9 7 27 7 7 8 8 8 8 8 8 8 8 8 9 7 9 7 27 7 7
7 7 7 9 7 7 7 7 7 7 7 9 7 7 7 7 7 7 7 7 7 7 7 7 7 7 7 7 7 7 7 7
9 9 7 9 9 7 7 9 9 9 15 9 9 9 9 9 9 9 9 9 9 9 9 9 9 9 7 9 7 9 7 9
7 9 7 7 7 7 7 7 9 17 17 17 17 17 17 17 17 17 17 9 7 7 7 7 7 7 7 7 27 7 7 7
7 9 9 9 9 9 7 7 9 17 17 17 17 17 17 17 17 17 17 9 7 7 7 7 27 7 7 7 7 7 27 7
7 7 7 7 7 7 7 7 9 17 17 17 17 17 17 17 17 17 17 9 7 27 7 27 7 7 27 7 27 7 7 7
9 9 9 9 9 9 9 9 9 17 17 17 17 17 17 17 17 17 17 9 7 7 7 7 7 7 7 7 7 7 7 7
7 7 7 7 7 7 7 7 9 17 17 17 17 17 17 17 17 17 17 9 7 7 27 7 7 9 7 7 7 7 7 7
9 9 7 27 7 7 7 7 9 17 17 17 17 17 17 17 17 17 17 9 7 7 7 27 7 9 7 27 7 7 7 7
9 7 7 7 7 7 7 7 9 17 17 17 17 17 17 17 17 17 17 9 7 7 7 7 7 9 7 7 7 7 7 7
9 7 7 7 7 7 9 9 9 17 17 17 17 17 17 17 17 17 17 9 7 27 7 7 7 9 9 9 9 9 9 9
9 7 7 7 7 27 7 7 15 17 17 17 17 17 17 17 17 17 17 9 9 7 7 7 27 7 7 7 7 7 7 7
9 7 7 7 7 7 7 7 15 17 17 17 17 17 17 17 17 17 17 15 7 7 7 7 7 7 7 7 27 7 27 7
9 7 9 7 7 7 7 9 15 15 15 9 9 9 9 9 9 9 9 9 9 9 9 9 7 7 27 7 7 27 7 27
9 7 7 7 9 7 7 9 9 7 7 9 7 7 7 7 7 7 7 7 7 7 7 7 7 7 7 7 7 7 7 7
9 7 9 9 9 7 7 7 7 27 7 9 27 7 9 7 7 7 7 7 7 27 7 9 7 27 7 27 7 27 7 27
7 7 7 7 7 7 7 7 7 7 7 9 7 7 9 7 7 27 9 9 7 7 7 9 7 7 7 7 7 7 7 7
7 7 7 7 9 7 7 9 7 7 7 7 27 7 9 27 7 7 9 9 7 7 7 9 7 7 7 7 7 27 7 7
7 27 8 8 8 15 15 8 7 7 7 9 7 7 7 7 7 7 7 7 7 7 7 7 7 7 7 7 7 7 7 7
27 7 8 17 17 17 17 8 7 7 7 7 7 7 9 7 7 7 7 7 27 7 7 9 7 27 27 7 27 7 7 7
7 7 8 17 17 17 17 8 7 7 7 7 7 7 9 7 7 7 7 7 7 7 7 9 7 7 7 7 7 7 7 27
7 7 8 17 17 17 17 8 7 27 27 9 7 7 9 9 9 9 7 9 7 9 7 9 9 7 7 7 27 7 7 7
7 7 8 8 8 8 8 8 7 7 7 9 7 9 7 7 7 7 27 7 7 7 7 7 7 7 7 7 7 7 7 7
7 7 7 7 7 7 7 7 7 7 7 7 7 7 7 7 7 7 7 7 7 7 7 7 7 7 7 7 7 7 7 7
