0 0 0 21 21 21 21 21 21 21 10 10 10 10 10 10 10 10 10 10 21 21 8 8 8 8 8 8 8 8 8 8
0 0 21 21 21 17 21 21 10 10 10 10 10 10 10 10 10 10 10 10 21 21 8 17 17 17 17 17 17 17 17 8
0 21 21 21 17 17 17 10 10 10 10 10 10 10 10 10 10 10 10 21 21 21 8 17 17 17 17 17 17 17 17 8
21 21 21 21 21 17 17 17 10 10 10 10 10 10 10 10 21 21 21 21 21 0 15 17 17 17 17 17 17 17 17 8
21 21 21 10 10 10 17 17 17 10 10 10 21 21 21 21 21 21 21 21 21 0 15 17 17 17 9 9 17 17 17 8
21 21 10 10 10 10 10 17 17 17 21 21 21 21 21 21 21 21 21 21 0 0 15 17 17 17 9 9 17 17 17 8
21 10 10 10 10 10 10 10 17 17 17 21 21 21 21 0 0 0 0 0 0 0 8 17 17 17 17 17 17 17 17 8
10 10 10 10 10 10 10 10 21 17 21 21 21 0 0 0 0 0 0 0 0 0 8 17 17 17 17 17 17 17 17 8
10 10 10 10 10 10 10 21 21 21 21 21 21 21 21 0 0 0 0 0 0 0 15 17 17 17 17 17 17 17 17 8
10 10 10 10 10 10 10 21 21 21 21 21 21 21 21 21 21 21 21 0 0 0 15 15 8 8 15 15 15 8 8 8
10 10 10 10 10 10 10 10 10 21 21 21 21 21 17 17 17 21 21 21 21 21 21 21 21 21 21 21 21 0 0 0
21 10 10 10 10 10 10 10 10 10 10 21 21 21 17 17 17 21 21 21 21 21 21 21 21 21 21 21 21 21 21 21
21 21 10 10 10 10 10 10 10 10 10 10 10 10 17 17 17 10 10 10 10 21 21 21 21 21 21 21 21 21 21 21
0 21 21 10 10 10 10 10 10 10 10 10 10 10 17 17 17 10 10 10 10 10 10 10 10 10 10 21 10 21 21 21
0 0 21 21 10 10 10 10 10 10 10 10 10 10 17 17 17 10 10 10 10 10 10 10 10 10 10 10 10 10 10 10
0 0 21 21 21 10 10 10 10 10 10 10 10 10 17 17 17 10 10 10 10 10 10 10 10 10 10 10 10 10 10 10
0 0 0 0 21 21 21 21 21 21 21 21 21 21 17 17 17 10 10 10 10 10 10 10 10 10 10 10 10 10 10 10
8 8 8 8 15 15 0 21 21 21 21 21 21 21 17 17 17 21 21 21 21 10 10 10 10 10 10 10 10 10 10 10
8 17 17 17 17 15 0 0 0 0 0 0 0 0 0 21 21 21 21 21 21 21 21 10 10 10 10 10 10 10 10 10
8 17 17 17 17 8 0 0 0 0 0 0 0 0 0 0 21 21 21 21 21 21 21 10 10 10 10 10 10 10 10 10
8 17 17 17 17 8 0 0 0 0 0 0 0 21 21 21 21 21 21 21 21 10 10 10 10 10 10 10 10 10 10 10
8 17 17 17 17 15 0 0 0 0 21 21 21 21 21 21 17 21 21 21 10 10 10 10 10 10 10 10 10 10 10 10
8 17 17 17 17 15 0 0 0 21 21 21 21 21 21 17 17 17 10 10 10 10 10 10 10 10 10 10 10 10 10 10
8 17 17 17 17 15 0 21 21 21 21 21 10 10 10 10 17 17 17 10 10 10 10 10 10 10 10 10 10 10 10 10
8 15 15 8 8 8 21 21 21 21 10 10 10 10 10 10 10 17 17 17 10 10 10 10 10 10 10 10 10 10 10 10
0 0 0 21 21 21 21 10 10 10 10 10 10 10 10 10 10 10 17 17 17 21 21 21 21 21 21 21 21 21 21 21
0 0 21 21 21 21 10 10 10 10 10 10 10 10 10 10 10 10 10 17 17 17 21 21 21 8 8 15 15 15 8 8
0 21 21 21 21 10 10 10 10 10 10 10 10 10 10 10 10 10 21 21 17 21 21 21 21 15 17 17 17 17 17 8
0 21 21 21 10 10 10 10 10 10 10 10 10 10 21 21 21 21 21 21 21 21 21 21 0 15 17 17 17 17 17 8
21 21 10 10 10 10 10 10 10 10 10 21 21 21 21 21 21 21 0 21 0 0 0 0 0 15 17 17 17 17 17 8
21 10 10 10 10 10 10 10 10 21 21 21 21 0 0 0 0 0 0 0 0 0 0 0 0 8 17 17 17 17 17 8
21 10 10 10 10 10 10 10 21 21 21 21 0 0 0 0 0 0 0 0 0 0 0 0 0 8 8 8 8 8 8 8
