0 0 0 0 0 0 0 0 0 0 0 0 0 0 0 0 0 0 0 0 0 0 0 0 0 0 0 0 0 0 0 0
0 0 0 0 0 0 0 0 0 0 0 0 0 0 0 0 0 0 0 0 0 0 0 0 0 0 0 0 0 0 0 0
0 0 0 0 0 0 0 0 0 0 0 0 0 0 0 14 14 14 0 0 0 0 0 0 0 0 0 0 0 0 0 0
0 0 0 0 0 0 0 0 10 10 10 10 10 10 10 14 14 14 10 10 10 10 10 10 10 0 0 0 0 0 0 0
0 0 0 0 0 0 0 10 10 10 10 10 10 10 10 14 14 14 10 10 10 10 10 10 10 10 0 0 0 0 0 0
0 0 0 0 0 0 0 10 10 0 0 0 0 0 0 14 14 14 0 0 0 0 0 0 10 10 0 0 0 0 0 0
0 0 0 0 0 0 10 10 0 0 0 0 0 0 0 0 0 0 0 0 0 0 0 0 0 10 10 0 0 0 0 0
0 0 0 0 0 10 10 0 0 9 0 9 0 9 0 0 0 0 0 9 0 9 0 9 0 10 10 10 0 0 0 0
0 0 0 0 0 10 10 0 0 0 9 9 9 0 0 0 0 0 0 0 9 9 9 0 0 0 10 10 0 0 0 0
0 0 0 0 0 10 10 0 0 9 9 9 9 9 9 15 15 15 9 9 9 9 9 9 0 0 10 10 0 0 0 0
0 0 0 0 0 10 10 0 0 0 9 9 9 0 0 0 0 0 0 0 9 9 9 0 0 0 10 10 0 0 0 0
0 0 0 0 0 10 10 0 0 9 0 9 0 0 0 0 0 0 0 0 0 9 0 9 0 0 10 10 0 0 0 0
0 0 0 0 0 10 10 0 0 0 0 9 0 0 8 0 0 0 8 0 0 9 0 0 0 0 10 10 0 0 0 0
0 0 0 0 14 14 14 14 0 0 0 9 0 0 0 0 0 0 0 0 0 9 0 0 0 14 14 14 14 0 0 0
0 0 0 0 14 14 14 14 0 0 0 9 0 0 0 0 0 0 0 0 0 9 0 0 0 14 14 14 14 0 0 0
0 0 0 0 0 10 10 0 0 0 0 9 0 0 8 0 0 0 8 0 0 9 0 0 0 0 10 10 0 0 0 0
0 0 0 0 0 10 10 0 0 9 0 9 0 0 0 0 0 0 0 0 0 9 0 9 0 0 10 10 0 0 0 0
0 0 0 0 0 10 10 0 0 0 9 9 9 0 0 0 0 0 0 0 9 9 9 0 0 0 10 10 0 0 0 0
0 0 0 0 0 10 10 0 0 9 9 9 9 9 9 9 9 9 9 9 9 9 9 9 0 0 10 10 0 0 0 0
0 0 0 0 0 10 10 0 0 0 9 9 9 0 0 0 0 0 0 0 9 9 9 0 0 0 10 10 0 0 0 0
0 0 0 0 0 10 10 0 0 9 0 9 0 9 0 0 0 0 0 9 0 9 0 9 0 0 10 10 0 0 0 0
0 0 0 0 0 10 10 10 0 0 0 0 0 0 0 0 0 0 0 0 0 0 0 0 0 0 10 10 0 0 0 0
0 0 0 0 0 0 10 10 10 0 0 0 0 0 0 0 0 0 0 0 0 0 0 0 0 10 10 10 0 0 0 0
0 0 0 0 0 0 0 10 10 10 0 0 0 0 0 14 14 14 0 0 0 0 0 0 10 10 10 0 0 0 0 0
0 0 0 0 0 0 0 0 10 10 10 10 10 10 10 14 14 14 10 10 10 10 10 10 10 10 0 0 0 0 0 0
0 0 0 0 0 0 0 0 0 10 10 10 10 10 10 14 14 14 10 10 10 10 10 0 0 0 0 0 0 0 0 0
0 0 0 0 0 0 0 0 0 0 0 0 0 0 0 14 14 14 0 0 0 0 0 0 0 0 0 0 0 0 0 0
0 0 0 0 0 0 0 0 0 0 0 0 0 0 0 0 0 0 0 0 0 0 0 0 0 0 0 0 0 0 0 0
0 0 0 0 0 0 0 0 0 0 0 0 0 0 0 0 0 0 0 0 0 0 0 0 0 0 0 9 9 9 9 9
0 0 0 0 0 0 0 0 0 0 0 0 0 0 0 0 0 0 0 0 0 0 0 0 0 0 0 15 16 16 16 9
0 0 0 0 0 0 0 0 0 0 0 0 0 0 0 0 0 0 0 0 0 0 0 0 0 0 0 15 16 16 16 9
0 0 0 0 0 0 0 0 0 0 0 0 0 0 0 0 0 0 0 0 0 0 0 0 0 0 0 9 9 9 9 9
