0 0 0 0 9 9 9 9 0 0 9 5 5 5 5 5 5 4 0 0 0 0 0 0 3 4 5 5 5 5 5 5
0 0 0 0 9 0 27 0 0 0 9 5 6 6 6 6 5 4 9 0 0 0 0 0 3 4 5 6 6 6 6 5
0 0 0 9 9 0 0 0 0 0 0 5 6 7 7 6 5 4 0 0 0 0 0 0 3 9 9 6 7 7 6 5
0 0 0 9 0 0 0 0 27 0 9 5 6 7 7 6 27 4 0 0 0 0 0 0 3 3 9 6 7 7 27 5
0 0 0 0 0 0 0 0 0 0 4 5 6 6 6 6 5 4 0 9 0 9 0 0 27 3 9 6 7 7 6 5
3 3 3 3 9 9 9 9 9 0 4 5 5 5 5 5 5 4 0 9 0 0 0 0 0 9 9 6 6 6 6 5
4 4 4 4 4 4 9 9 9 3 4 4 4 4 4 4 4 27 0 9 0 0 0 0 0 3 3 9 5 5 5 5
4 5 5 5 5 5 9 9 9 9 9 4 4 4 4 9 4 3 0 9 0 0 0 9 0 0 0 3 9 4 4 4
4 5 6 6 6 5 0 3 4 9 9 9 9 5 5 5 9 3 0 9 0 0 0 0 0 0 0 0 3 3 3 3
4 5 6 7 6 5 9 3 4 5 9 9 9 9 6 5 4 3 0 9 0 0 27 3 3 3 3 3 3 0 0 0
4 5 6 7 6 9 9 3 4 5 6 6 7 7 6 5 4 3 0 9 0 0 0 3 4 4 4 4 4 0 0 27
4 27 6 7 6 5 9 3 4 5 6 7 7 7 6 5 4 3 0 0 0 0 0 3 4 5 5 5 9 27 0 0
4 5 6 6 6 5 4 9 4 5 6 6 6 6 6 5 4 3 0 0 0 0 0 3 4 5 6 6 27 0 0 0
4 5 5 5 5 5 4 3 4 9 5 5 5 5 5 5 4 9 9 0 0 0 9 9 4 5 6 7 9 0 0 0
4 4 4 9 4 4 4 3 4 9 4 4 4 4 9 4 4 9 9 0 27 0 0 3 4 9 9 9 9 0 0 0
3 3 3 9 3 3 3 3 3 3 9 3 3 3 3 3 3 9 9 0 0 0 0 0 0 0 0 0 0 0 0 0
3 0 0 9 0 0 0 27 0 0 0 9 9 0 0 0 0 0 1 0 0 0 0 0 0 0 27 0 0 27 0 27
0 0 0 9 0 0 0 0 0 0 27 0 9 9 0 0 0 0 1 0 27 0 27 0 0 0 0 0 0 0 0 0
0 0 0 9 0 0 27 0 0 0 0 27 0 9 9 9 0 0 1 0 0 0 0 3 3 3 3 3 3 3 3 3
0 0 0 0 0 0 0 0 0 0 27 0 0 0 0 0 9 0 9 0 0 27 0 3 4 4 0 4 4 4 4 4
0 27 0 9 0 0 0 0 0 0 0 0 0 0 0 0 0 9 9 0 0 0 0 3 4 5 5 5 5 9 4 4
0 27 0 0 0 3 9 9 9 9 9 9 9 9 0 0 0 0 9 9 0 0 3 3 4 5 6 6 6 9 9 4
0 0 0 0 0 3 4 5 5 6 6 6 6 9 0 0 0 0 9 0 9 9 3 3 4 5 6 7 7 6 9 4
0 27 0 9 9 3 4 5 5 6 7 7 6 9 3 3 3 0 9 0 0 0 9 9 9 9 9 7 7 9 9 9
0 0 0 9 9 3 4 5 5 6 7 7 6 9 4 4 3 0 1 0 0 0 0 3 4 5 6 7 7 6 5 4
0 27 0 0 0 3 4 5 5 9 9 6 6 9 5 4 3 0 1 0 0 0 0 3 4 5 6 6 6 6 5 4
27 0 0 0 0 3 4 5 5 9 5 5 5 5 5 4 3 0 1 0 0 0 0 3 4 5 9 5 5 5 9 4
0 27 0 9 9 9 4 5 5 5 5 5 5 5 5 4 9 0 1 0 0 0 9 3 9 4 4 4 4 4 4 4
0 0 0 9 9 9 9 4 4 27 4 4 4 4 4 4 3 0 9 0 0 0 0 0 9 3 3 3 0 3 3 3
0 0 0 0 0 0 0 3 3 3 3 3 9 3 3 3 3 0 9 0 0 0 0 0 9 0 0 0 0 0 0 0
27 0 0 0 0 0 0 0 0 27 0 0 0 9 0 0 0 0 9 0 0 0 0 0 0 0 0 0 9 0 0 0
0 0 0 0 27 0 0 0 0 0 0 0 0 0 0 0 0 0 9 0 0 0 0 0 0 0 0 0 0 0 0 0
