9 9 9 9 9 9 9 9 9 9 9 9 9 9 9 9 9 9 9 9 9 9 9 9 9 9 9 9 9 0 0 0
9 9 9 9 9 9 9 9 9 9 9 9 9 9 9 9 9 9 9 9 9 9 9 9 9 9 9 9 9 0 0 0
9 8 8 8 8 8 8 8 8 8 8 8 9 9 9 9 9 9 9 9 9 9 9 9 9 9 9 9 21 21 21 21
9 8 17 17 17 17 17 17 17 17 17 8 9 9 9 9 9 9 9 9 9 9 9 9 9 21 21 21 10 10 10 10
9 8 17 17 17 17 17 17 17 17 17 8 8 8 8 8 8 8 8 8 8 8 9 21 21 21 21 10 10 10 10 10
9 8 17 17 17 17 17 17 17 17 17 17 17 17 17 17 17 17 17 17 17 8 21 21 21 21 10 10 10 10 10 10
9 8 17 17 17 17 17 17 17 17 17 17 17 17 17 17 17 17 17 17 16 16 17 21 10 10 10 10 10 10 10 10
9 8 17 17 17 17 17 17 17 17 17 8 8 8 8 8 8 8 8 8 16 17 17 17 10 10 10 10 10 10 10 10
9 8 17 17 17 17 17 17 17 17 17 8 9 9 9 9 9 9 9 9 17 17 17 17 17 10 10 10 10 21 21 21
9 8 8 17 17 8 8 8 8 8 8 8 9 9 9 9 9 21 21 21 10 17 17 17 17 17 10 10 21 21 21 21
9 9 8 17 17 8 9 9 9 9 9 9 9 9 21 21 21 21 21 10 10 10 17 17 17 17 17 21 21 21 21 21
9 9 8 17 17 8 9 9 9 9 9 9 21 21 21 21 21 21 10 10 10 10 10 17 17 17 17 17 21 0 0 0
9 9 8 17 17 8 9 9 9 21 21 21 21 21 21 21 21 10 10 10 10 10 10 10 17 17 17 21 0 0 0 0
9 9 8 17 17 8 9 9 21 21 21 21 21 21 21 10 10 10 10 10 10 10 10 21 21 17 21 0 0 0 0 0
9 9 8 17 17 8 9 21 21 21 21 21 10 10 10 10 10 10 10 10 10 10 21 21 21 21 0 0 0 0 0 0
9 9 8 17 17 8 21 21 21 21 10 10 10 10 10 10 10 10 10 10 21 21 21 21 21 21 0 0 0 0 0 0
9 9 8 17 17 8 21 21 21 10 10 10 10 10 10 10 10 10 21 21 21 21 21 21 0 0 0 0 0 0 0 0
9 9 8 17 17 8 21 21 10 10 10 10 10 10 10 10 21 21 21 21 0 0 0 0 0 0 0 0 0 0 0 0
9 9 8 17 17 8 21 21 10 10 10 10 10 10 10 21 21 21 0 0 0 0 0 0 0 0 0 0 0 0 0 0
9 9 8 17 16 16 17 10 10 10 10 10 10 10 21 21 0 0 0 0 0 0 0 8 8 16 16 16 8 8 0 0
9 9 8 8 16 17 17 17 10 10 10 10 10 21 21 8 8 8 8 8 0 0 0 8 17 17 17 17 17 8 0 0
9 9 9 21 17 17 17 17 17 10 10 10 10 21 0 8 17 17 17 8 0 0 0 8 17 17 17 17 17 8 0 0
9 9 9 21 21 17 17 17 17 17 10 10 21 0 0 8 17 17 17 8 0 0 0 8 17 17 17 17 17 8 0 0
9 9 21 21 21 10 17 17 17 17 17 21 21 0 0 8 17 17 17 8 0 0 0 8 17 17 17 17 17 8 0 0
9 9 21 21 10 10 10 17 17 17 17 17 0 0 0 8 16 16 16 8 0 0 0 8 17 17 17 17 17 8 0 0
9 21 21 10 10 10 10 10 17 17 17 17 17 0 0 0 0 0 0 0 0 0 0 8 17 17 17 17 17 8 0 0
9 21 21 10 10 10 10 10 10 17 17 17 0 0 0 0 0 0 0 0 0 0 0 8 17 17 17 17 17 8 0 0
21 21 10 10 10 10 10 10 10 21 17 0 0 0 0 0 0 0 0 0 0 8 8 8 17 17 17 17 17 8 0 0
21 10 10 10 10 10 10 10 21 21 0 0 0 0 0 0 0 0 0 0 0 8 17 17 17 17 17 17 17 8 0 0
21 10 10 10 10 10 10 10 21 21 0 0 0 0 0 0 0 0 0 0 0 16 17 17 17 17 17 17 17 16 0 0
21 10 10 10 10 10 10 21 21 0 0 0 0 0 0 0 0 0 0 0 0 16 17 17 17 17 17 17 17 16 0 0
21 10 10 10 10 10 21 21 0 0 0 0 0 0 0 0 0 0 0 0 0 8 8 8 8 8 8 8 8 8 0 0
