9 9 9 9 9 9 9 9 9 9 9 9 9 9 9 0 0 0 0 0 9 9 9 9 9 9 9 9 9 9 9 9
9 9 9 9 9 9 9 9 9 9 9 9 9 9 9 0 3 5 0 8 8 8 8 8 8 8 8 8 8 8 8 8
9 9 9 9 9 9 9 9 9 9 9 9 9 9 9 0 3 3 0 8 17 17 17 17 17 17 17 17 17 17 17 8
9 9 9 9 9 9 9 9 9 9 9 9 9 9 9 0 5 3 5 15 17 17 17 17 17 17 17 17 17 17 17 8
9 9 9 9 9 9 9 9 9 9 9 9 9 9 9 3 5 5 5 15 17 17 17 17 17 17 17 17 17 17 17 8
9 9 8 8 8 8 8 9 9 9 9 9 9 9 9 3 3 3 5 15 17 17 17 17 17 17 17 17 17 17 17 8
9 9 8 17 17 17 8 9 9 9 9 9 9 9 3 3 5 0 0 8 17 17 17 17 17 17 17 17 17 17 17 8
9 9 8 17 17 17 8 9 9 9 9 9 0 3 3 5 0 0 0 8 8 8 8 8 8 8 8 8 17 17 17 8
9 9 8 17 17 17 8 9 9 9 9 0 0 3 5 5 0 0 9 9 9 9 9 9 9 9 9 8 17 17 17 8
9 9 8 17 17 17 8 9 9 9 0 0 4 3 5 0 0 0 9 9 9 9 9 9 9 9 9 8 17 17 17 8
9 9 8 17 17 17 8 9 0 0 0 4 3 0 0 9 9 9 9 9 9 9 9 9 9 9 9 8 17 17 17 8
9 9 8 17 17 17 8 9 0 0 5 4 0 3 0 9 9 9 9 9 9 9 9 9 9 9 0 8 15 15 8 8
0 0 8 15 15 15 8 0 3 5 5 0 0 0 0 9 9 9 9 9 9 9 9 9 9 9 0 3 4 3 0 0
0 0 0 0 5 5 0 3 4 4 3 0 0 0 9 9 9 9 9 9 9 9 9 9 9 9 0 3 4 4 0 0
3 3 3 5 5 3 3 3 4 3 3 0 3 9 9 9 9 9 9 9 9 9 9 9 9 9 0 0 5 5 3 0
0 3 3 5 5 5 3 4 4 0 0 0 0 9 9 9 9 9 9 9 9 9 9 9 0 0 0 0 0 5 3 0
0 0 0 3 4 4 4 4 0 0 9 9 9 9 9 9 9 9 9 9 9 9 9 9 0 0 0 0 5 5 3 0
0 0 0 3 4 3 3 0 0 0 9 9 9 9 9 9 9 9 9 9 9 9 9 9 0 0 0 0 5 4 3 0
0 0 0 3 5 3 0 0 0 0 9 9 9 9 9 9 9 9 9 9 9 9 9 9 0 0 0 0 5 4 3 0
0 0 0 4 5 3 0 0 0 0 9 9 9 9 9 9 9 9 9 9 9 9 9 9 0 0 0 0 5 3 0 0
0 0 0 4 5 3 0 0 0 0 9 9 9 9 9 9 9 9 9 9 9 9 9 9 0 8 8 8 15 15 8 8
0 0 8 15 15 8 8 0 0 9 9 9 9 9 9 9 9 9 9 9 9 9 9 0 0 8 17 17 17 17 17 8
9 9 8 17 17 17 8 9 9 9 9 9 9 9 9 9 9 9 9 9 9 9 0 0 0 8 17 17 17 17 17 8
9 9 8 17 17 17 8 9 9 9 9 9 9 9 9 9 9 9 9 9 9 9 0 0 0 8 17 17 17 17 17 8
9 9 8 17 17 17 8 9 9 9 9 9 9 9 9 9 9 9 9 9 9 9 0 0 0 8 17 17 17 17 17 8
9 9 8 17 17 17 8 8 8 8 8 8 9 9 9 9 9 9 9 9 9 8 8 8 8 8 17 17 17 17 17 8
9 9 8 17 17 17 17 17 17 17 17 8 0 0 0 0 9 9 9 9 9 8 17 17 17 17 17 17 17 17 17 8
9 9 8 17 17 17 17 17 17 17 17 15 4 4 4 0 9 0 0 0 0 8 17 17 17 17 17 17 17 17 17 8
9 9 8 17 17 17 17 17 17 17 17 15 5 5 4 4 4 3 3 3 4 15 17 17 17 17 17 17 17 17 17 8
9 9 8 8 8 8 8 8 8 8 8 8 5 5 5 5 4 4 5 5 4 15 17 17 17 17 17 17 17 17 17 8
9 9 9 9 9 9 9 9 9 9 0 0 3 5 3 3 3 3 5 3 3 8 17 17 17 17 17 17 17 17 17 8
9 9 9 9 9 9 9 9 9 9 0 0 5 5 0 0 3 3 0 3 3 8 8 8 8 8 8 8 8 8 8 8
