0 0 0 8 8 8 8 8 0 0 0 0 0 0 0 0 0 0 0 0 0 0 0 0 8 8 8 8 8 0 0 0
0 0 0 8 17 17 17 8 3 2 6 4 2 0 3 0 2 0 2 4 2 0 0 0 8 17 17 17 8 0 0 0
0 0 0 8 17 17 17 15 2 6 6 0 7 6 7 0 3 0 0 7 6 4 4 0 15 17 17 17 8 0 0 0
0 0 0 8 17 17 17 8 0 3 4 6 2 0 0 3 7 3 0 6 4 0 0 0 8 17 17 17 8 0 0 0
0 0 0 8 8 8 8 8 0 0 0 4 0 0 2 3 3 6 4 2 0 0 0 0 8 8 8 8 8 0 0 0
0 0 0 0 0 0 0 0 0 0 0 0 0 3 0 0 3 6 2 0 0 0 0 0 0 0 0 0 0 0 9 9
21 9 9 0 0 0 0 0 0 0 0 0 0 0 4 4 6 4 6 0 0 0 0 0 0 0 0 0 0 0 9 9
21 9 9 0 0 0 0 0 0 0 0 0 0 0 0 3 0 2 0 0 0 0 0 0 0 0 0 9 9 0 0 21
21 21 21 21 0 9 9 0 0 0 0 0 0 0 0 2 6 4 0 0 0 0 0 0 0 0 0 9 9 21 21 21
10 10 21 21 21 9 9 0 0 9 9 0 0 9 9 0 3 7 0 9 9 0 0 9 9 21 21 21 21 21 21 10
10 10 10 10 21 21 21 21 21 9 9 21 21 9 9 21 0 21 21 9 9 21 21 9 9 21 21 21 10 10 10 10
10 10 10 10 10 10 21 21 21 21 21 21 21 21 21 21 17 17 21 21 21 21 21 21 21 21 10 10 10 10 10 10
21 21 10 10 10 10 10 10 10 10 10 10 10 10 10 10 17 17 10 10 10 10 10 10 10 10 10 10 10 10 10 10
21 21 21 21 10 10 10 10 10 10 10 10 10 10 10 10 17 17 10 10 10 10 10 10 10 10 10 10 10 21 21 21
21 21 21 21 21 21 10 10 10 10 10 10 10 10 10 10 17 17 10 10 10 10 10 10 10 10 21 21 21 21 21 21
0 9 9 0 21 21 21 21 21 21 21 21 21 21 21 21 17 17 21 21 21 21 21 21 21 21 21 9 9 0 21 9
0 9 9 0 21 9 9 0 21 9 9 0 21 9 9 21 7 6 21 9 9 0 0 9 9 0 21 9 9 0 0 9
0 0 0 0 0 9 9 0 0 9 9 0 0 9 9 0 5 7 0 9 9 0 0 9 9 0 0 0 0 0 0 0
0 0 0 0 0 0 0 0 0 0 0 0 0 0 0 2 4 0 0 0 0 0 0 0 0 0 0 0 0 0 0 0
0 0 0 0 0 0 0 0 0 0 0 0 0 0 2 4 3 2 0 0 0 0 0 0 0 0 0 0 0 0 0 0
0 0 0 0 0 0 0 0 0 0 0 0 0 0 2 4 7 0 4 0 0 0 0 0 0 0 0 0 0 0 0 0
0 0 0 0 0 0 0 0 0 0 0 0 2 4 6 4 3 7 3 0 0 0 0 0 0 0 0 0 0 0 0 0
0 0 0 0 0 0 0 0 0 0 2 0 0 3 5 6 3 0 5 2 0 0 0 0 0 0 0 0 0 0 0 0
0 0 0 0 0 0 0 0 0 0 0 2 4 6 3 0 0 5 7 3 0 0 0 0 0 0 0 0 0 0 0 0
0 0 0 0 0 0 0 0 0 2 0 3 5 5 0 0 0 0 0 2 5 3 0 0 0 0 0 0 0 0 0 0
0 0 0 8 8 8 8 8 0 0 2 5 0 6 3 0 0 3 3 7 0 6 3 0 8 8 8 8 8 0 0 0
0 0 0 8 17 17 17 8 0 4 6 5 4 3 0 3 0 6 7 3 4 2 7 3 8 17 17 17 8 0 0 0
0 0 0 8 17 17 17 15 4 3 6 6 3 5 5 4 5 0 4 0 6 4 5 5 15 17 17 17 8 0 0 0
0 0 0 8 17 17 17 8 5 4 3 2 5 2 3 6 0 3 5 4 2 4 2 4 8 17 17 17 8 0 0 0
0 0 0 8 8 8 8 8 0 2 0 0 0 0 0 0 2 5 0 0 0 0 0 0 8 8 8 8 8 0 0 0
0 0 0 0 0 0 0 0 0 0 0 0 0 0 0 0 0 0 0 0 0 0 0 0 0 0 0 0 0 0 0 0
0 0 0 0 0 0 0 0 0 0 0 0 0 0 0 0 0 0 0 0 0 0 0 0 0 0 0 0 0 0 0 0
