0 8 8 17 8 8 8 8 0 0 0 21 21 10 10 10 21 21 21 0 0 4 4 0 20 20 20 20 20 20 20 0
0 8 17 17 17 17 17 8 0 0 0 21 21 10 10 10 10 21 17 5 5 5 5 0 15 17 17 17 17 17 20 0
0 8 17 17 17 17 17 8 0 0 0 0 21 21 10 10 10 17 17 4 4 4 4 5 15 17 17 17 17 17 20 0
0 8 17 17 17 17 17 15 3 3 0 0 21 21 10 10 17 17 17 21 0 4 0 0 20 17 17 17 17 17 20 0
0 8 8 8 8 8 15 15 3 0 0 0 0 21 21 17 17 17 10 21 21 0 0 0 20 17 17 17 17 17 20 0
21 21 21 0 0 0 3 6 5 3 0 0 4 0 17 17 17 10 10 21 21 0 0 0 20 15 15 20 20 20 20 0
10 21 21 0 0 0 0 3 5 4 4 5 6 4 4 17 10 10 10 10 21 21 0 0 0 4 5 0 0 0 0 0
10 10 21 21 0 0 0 4 4 5 7 6 5 4 4 4 21 10 10 10 21 21 21 0 4 5 4 4 0 0 0 0
10 10 10 21 21 0 6 5 5 0 5 6 6 4 0 4 21 10 10 10 10 21 21 0 0 4 4 0 0 0 0 0
10 10 10 10 21 17 5 4 4 4 0 7 5 4 0 0 21 21 10 10 10 10 21 21 0 4 4 0 0 0 0 0
21 10 10 10 17 17 17 0 0 0 4 4 6 5 4 0 21 21 10 10 10 10 21 21 21 5 4 0 0 0 0 0
21 21 10 17 17 17 21 21 0 0 0 4 5 6 4 0 21 21 21 10 10 10 10 21 21 7 4 0 0 0 0 0
0 21 17 17 17 10 21 21 21 0 0 0 4 5 6 4 0 21 21 10 10 10 10 10 21 17 17 21 0 0 0 0
0 17 17 17 10 10 10 21 21 21 0 0 4 5 5 4 4 21 21 21 10 10 10 10 10 17 17 21 21 21 0 0
0 4 17 21 10 10 10 10 21 21 21 0 0 4 6 5 4 0 21 21 21 10 10 10 10 17 17 21 21 21 21 0
4 4 0 21 21 10 10 10 10 21 21 0 0 4 5 5 5 4 0 21 21 21 10 10 10 17 17 10 10 21 21 21
4 6 5 0 21 21 10 10 10 10 21 21 0 0 4 6 5 5 0 0 21 21 21 10 10 17 17 10 10 10 21 21
4 6 4 3 0 21 21 10 10 10 21 21 4 4 5 5 6 5 4 3 0 21 21 21 21 17 17 10 10 10 10 10
4 5 4 3 0 0 21 21 10 10 10 21 17 7 5 4 4 6 4 3 3 0 0 21 21 17 17 10 10 10 10 10
4 4 3 0 0 0 21 21 10 10 10 17 17 17 0 4 3 3 4 5 3 0 0 0 21 17 17 21 21 10 10 10
0 6 3 4 0 0 0 21 10 10 17 17 17 21 4 0 0 4 3 6 4 3 0 0 3 6 5 0 21 21 21 10
5 6 4 0 0 0 0 21 21 17 17 17 21 21 0 0 0 0 3 7 5 3 0 3 4 5 5 3 0 0 21 21
0 6 4 0 0 0 0 21 17 17 17 10 10 21 21 0 0 0 0 4 5 4 0 0 4 4 4 3 3 0 0 0
8 15 15 8 8 8 0 6 7 17 10 10 10 21 21 0 0 0 0 4 15 15 8 8 8 15 15 8 8 8 0 0
8 17 17 17 17 15 5 5 3 21 10 10 10 10 21 21 0 0 0 0 15 17 17 17 17 17 17 17 17 8 0 0
8 17 17 17 17 15 3 3 3 21 21 10 10 10 21 21 21 0 0 0 8 17 17 17 17 17 17 17 17 8 0 0
8 17 17 17 17 8 0 3 0 0 21 21 10 10 10 21 21 0 0 0 8 17 17 17 17 17 17 17 17 8 0 0
8 17 17 17 17 8 3 3 3 3 0 21 10 10 10 10 21 0 4 0 8 17 17 17 17 17 17 17 17 8 0 0
8 17 17 17 17 15 5 3 7 6 6 17 17 17 17 17 17 17 4 4 15 17 17 17 17 17 17 17 17 8 0 0
8 17 17 17 17 15 5 5 3 3 7 17 17 17 17 17 17 17 6 6 15 17 17 17 17 17 17 17 17 8 0 0
8 8 8 8 8 8 0 3 0 0 0 0 21 10 10 10 10 21 21 4 8 8 8 8 8 8 8 8 8 8 0 0
0 0 0 0 0 0 0 0 0 0 0 0 0 21 10 10 10 21 21 0 0 0 0 0 0 0 0 0 0 0 0 0
