8 8 8 8 8 8 8 8 8 8 8 0 0 0 9 0 27 0 0 9 0 0 0 9 0 0 9 0 0 0 27 0
8 17 17 17 17 17 17 17 17 15 15 0 9 0 0 0 0 0 0 0 0 0 0 9 0 0 0 0 9 0 0 0
8 17 17 17 17 17 17 17 8 8 0 0 0 0 0 0 0 0 27 0 0 27 0 9 0 27 0 27 0 9 0 0
8 17 17 17 17 17 17 8 8 0 0 0 9 0 0 9 0 27 0 9 0 0 27 1 0 0 0 0 0 0 0 9
8 17 17 17 17 17 8 8 0 0 0 0 27 0 0 9 0 0 0 0 0 0 0 0 0 0 27 0 0 0 27 0
8 17 17 17 17 8 8 0 0 0 0 0 0 0 0 9 0 0 0 9 0 0 0 0 0 0 0 0 0 0 0 0
8 8 15 15 8 8 0 0 9 0 9 9 9 0 9 9 9 9 9 9 9 8 8 8 8 8 15 15 8 8 9 0
0 0 0 0 27 0 0 0 9 0 0 0 0 0 0 0 0 9 0 0 0 8 17 17 17 17 17 17 17 8 0 0
0 0 0 0 0 0 0 0 0 0 9 9 9 0 9 0 0 0 0 0 0 8 17 17 9 17 9 17 17 8 0 0
9 0 9 9 0 0 9 9 0 3 3 3 3 3 0 0 0 0 9 0 0 8 17 17 9 17 17 17 9 8 0 0
0 0 0 0 0 0 0 0 0 3 4 4 4 4 3 9 0 0 0 0 9 8 17 17 9 9 17 9 17 8 0 0
0 0 0 9 0 0 9 9 3 4 5 5 5 5 4 3 3 0 9 0 0 8 9 17 17 17 17 17 17 8 0 9
0 0 0 9 9 0 9 3 4 5 5 6 6 6 5 4 4 3 0 0 0 8 17 9 17 17 9 9 17 8 0 0
9 0 9 9 0 0 9 3 4 5 5 6 7 6 6 5 4 3 3 0 0 8 17 17 17 17 17 17 17 8 0 0
0 0 27 9 0 0 9 3 4 5 5 6 7 7 6 6 5 5 4 3 3 8 17 9 9 17 17 17 9 8 9 0
0 0 0 9 0 0 3 4 5 5 5 6 7 7 7 6 6 6 5 9 3 15 17 17 17 17 17 17 17 15 0 0
9 0 0 0 0 0 3 4 5 5 6 7 7 7 7 7 7 6 5 9 3 15 17 17 9 17 9 17 17 15 0 0
0 0 0 0 9 9 9 9 4 5 5 6 7 7 7 6 6 6 5 4 3 8 8 8 8 8 8 8 8 8 9 0
0 0 27 0 0 0 0 9 3 4 5 5 6 7 6 6 5 5 5 4 3 9 0 0 0 0 0 0 0 0 0 0
27 0 0 0 0 27 0 9 3 9 4 4 5 6 5 5 4 4 4 3 0 9 0 0 0 0 0 27 0 0 27 27
0 9 0 0 9 0 0 9 0 9 4 4 4 5 4 4 3 3 3 0 0 9 0 27 0 0 0 0 0 0 0 0
0 0 17 17 0 0 0 9 0 9 9 3 4 4 4 3 9 9 9 9 0 9 0 0 0 17 17 0 0 27 0 0
0 0 17 17 0 0 0 9 0 0 0 0 3 4 3 0 0 0 0 0 0 9 0 0 0 17 17 0 0 0 0 0
0 9 17 17 9 0 0 9 0 0 0 9 9 3 0 9 9 0 0 0 0 9 0 0 9 17 17 9 0 0 0 0
21 21 17 17 21 21 21 21 21 21 21 21 21 21 21 21 21 21 21 21 21 21 21 21 21 17 17 21 21 21 21 21
10 10 17 17 10 10 10 10 10 10 10 10 10 10 10 10 10 10 10 10 10 10 10 10 10 17 17 10 10 10 10 10
10 10 17 17 10 10 10 10 10 10 10 10 10 10 10 10 10 10 10 10 10 10 10 10 10 17 17 10 10 10 10 10
21 21 17 17 21 21 21 21 21 21 21 21 21 21 21 21 21 21 21 21 21 21 21 21 21 17 17 21 21 21 21 21
0 9 17 17 9 0 0 9 3 4 5 6 7 7 6 5 4 3 9 0 0 0 0 0 9 17 17 9 8 16 8 8
0 0 17 17 0 0 0 2 3 4 5 6 9 7 6 5 4 3 2 27 0 9 0 0 0 17 17 16 17 17 17 8
0 9 17 17 0 9 0 0 3 4 5 6 6 6 6 5 4 3 2 0 0 9 0 0 0 17 17 16 17 17 32 8
0 9 17 17 9 0 0 9 3 4 5 5 5 5 5 5 4 3 9 0 0 0 0 0 0 17 17 8 8 8 8 8
