10 10 10 0 0 0 0 4 4 4 0 17 17 17 17 0 0 0 0 0 0 0 0 0 0 0 0 0 0 0 0 0
10 10 10 10 0 14 7 7 7 4 4 14 14 14 14 7 4 4 4 4 0 0 0 0 0 0 0 0 0 0 0 0
10 10 10 10 14 14 14 0 4 4 4 14 14 14 17 4 5 7 7 7 4 0 0 0 0 0 0 0 0 0 0 0
0 0 10 14 14 14 10 10 10 10 0 17 17 17 17 4 4 4 4 4 4 7 7 4 0 0 0 0 0 0 0 0
0 0 14 14 14 10 10 10 10 10 10 10 10 10 10 0 0 0 0 0 0 4 5 5 4 0 0 0 0 0 0 0
0 4 5 14 0 10 10 10 10 10 10 10 10 10 10 10 10 0 0 0 0 0 4 4 7 4 0 0 0 0 10 10
0 4 5 4 0 0 9 0 0 0 10 10 10 10 10 10 10 10 10 0 0 0 0 0 4 4 4 0 0 10 10 10
4 7 4 4 0 0 0 0 0 0 0 0 0 10 10 10 10 10 10 10 10 0 0 0 0 4 7 14 10 10 10 10
4 4 7 4 4 0 17 17 17 17 0 0 0 0 27 18 10 10 10 10 10 10 10 0 0 0 14 14 14 10 10 10
4 7 4 7 7 4 14 14 14 17 0 0 0 0 6 18 18 18 0 10 10 10 10 10 10 10 10 14 14 14 10 10
4 5 7 4 4 4 14 14 14 17 0 0 18 6 7 18 18 18 0 0 10 10 10 10 10 10 10 10 14 14 14 0
4 4 7 4 0 0 17 17 17 0 27 18 18 18 7 0 6 18 0 0 0 10 10 10 10 10 10 10 10 14 7 0
0 4 7 4 0 0 0 0 0 0 0 18 18 18 18 7 6 0 0 0 0 0 0 10 10 10 10 0 0 4 4 4
0 4 5 4 0 0 0 0 0 0 6 7 27 0 6 6 0 0 0 0 16 16 0 0 0 0 0 0 16 0 4 4
0 17 14 14 17 0 0 0 0 6 7 7 6 6 0 0 0 0 0 16 6 5 2 0 0 0 0 16 4 16 4 4
0 17 14 14 17 0 0 0 0 18 18 7 6 0 0 0 0 0 16 5 6 6 5 0 0 0 0 4 7 7 4 4
0 17 14 14 17 0 0 0 18 18 18 18 0 0 0 0 0 0 0 0 5 5 4 0 0 0 0 0 4 4 7 4
0 17 17 17 17 0 0 0 18 18 18 0 0 0 0 0 0 0 0 0 0 6 4 0 0 16 16 0 0 0 5 4
0 0 0 0 0 0 0 0 18 18 18 0 0 0 0 0 0 0 0 0 0 4 4 0 16 16 16 16 0 0 4 7
0 0 0 0 0 0 0 18 18 18 27 0 0 0 0 0 0 16 16 0 0 4 7 16 16 14 14 16 16 0 0 5
0 0 0 0 0 0 6 7 7 7 6 0 0 0 0 0 16 16 16 16 0 4 0 16 16 14 14 16 16 0 4 7
0 0 0 0 0 0 0 7 7 7 6 0 0 0 0 16 16 14 14 16 16 4 4 0 16 14 14 16 0 0 5 7
0 0 0 0 0 0 6 0 27 7 6 0 0 0 0 16 16 14 14 14 14 5 4 4 0 14 14 4 4 4 7 4
0 0 0 0 0 0 0 7 7 7 18 0 0 0 0 0 16 16 16 14 7 7 7 4 4 5 4 4 4 4 4 0
0 0 0 0 0 0 0 6 18 18 18 18 0 0 0 0 0 16 16 5 4 5 5 7 4 4 5 7 7 7 4 0
0 0 0 0 0 0 0 6 7 18 18 18 0 0 0 0 0 0 0 0 4 4 5 5 7 7 7 7 5 5 0 0
0 0 0 0 0 0 0 0 7 18 18 6 0 0 0 0 0 0 0 0 16 14 5 4 5 5 5 4 0 0 0 0
0 0 0 0 0 0 0 0 6 6 7 6 0 0 0 0 0 0 0 16 16 14 14 4 4 0 4 0 0 0 0 0
0 0 0 0 0 0 0 0 27 6 7 27 0 0 0 0 0 0 16 16 14 14 16 16 0 0 0 0 0 0 0 0
0 0 0 0 0 0 0 0 6 6 6 6 0 0 0 0 0 0 16 16 14 14 16 16 0 0 0 0 0 0 0 0
0 0 0 0 0 0 0 0 0 6 7 6 0 0 0 0 0 0 0 16 16 16 16 0 0 0 0 0 0 0 0 0
0 0 0 0 0 0 0 0 0 6 7 7 0 0 0 0 0 0 0 0 16 16 0 0 0 0 0 0 0 0 0 0
