8 8 8 8 8 8 8 8 8 8 8 8 8 8 8 8 8 8 8 8 0 0 0 8 8 8 8 8 8 8 8 8
8 17 17 17 17 17 17 17 17 17 9 17 17 17 17 17 17 17 17 8 0 0 0 8 17 17 17 17 17 17 17 8
8 17 17 17 17 17 17 17 17 17 9 17 17 17 17 17 17 17 17 8 0 0 0 8 17 17 17 17 17 17 17 8
8 17 17 17 17 17 17 17 17 17 9 17 17 17 17 17 17 17 17 8 0 0 0 8 17 17 17 17 17 17 17 8
8 17 17 17 17 17 17 17 17 17 9 17 17 17 17 17 17 17 17 8 0 0 0 8 17 17 17 17 17 17 17 8
8 17 17 17 17 17 17 17 17 17 17 17 17 17 17 17 17 17 17 8 0 0 0 8 9 9 9 17 17 9 9 8
8 17 17 17 17 17 17 17 17 17 17 17 17 17 17 17 17 17 17 16 0 0 0 16 17 17 17 17 17 17 17 8
8 17 17 17 17 17 17 17 17 17 9 17 17 17 17 17 17 17 17 16 0 0 0 16 17 17 17 17 17 17 17 8
8 17 17 17 17 17 17 17 17 17 9 17 17 17 17 17 17 17 17 16 0 0 0 16 17 17 17 17 17 17 17 8
8 17 17 17 17 17 17 17 17 17 9 17 17 17 17 17 17 17 17 8 0 0 0 8 17 17 17 17 17 17 17 8
8 17 17 17 17 17 17 17 17 17 9 17 17 17 17 17 17 17 17 8 0 0 0 8 17 17 17 17 17 17 17 8
8 9 9 9 17 17 9 9 9 9 9 9 9 9 17 17 9 9 9 8 0 0 0 8 9 9 9 17 17 9 9 8
8 17 17 17 17 17 17 17 17 17 9 17 17 17 17 17 17 17 17 8 0 0 0 8 17 17 17 17 17 17 17 8
8 17 17 17 17 17 17 17 17 17 9 17 17 17 17 17 17 17 17 8 0 0 0 8 17 17 17 17 17 17 17 8
8 17 17 17 17 17 17 17 17 17 17 17 17 17 17 17 17 17 17 8 0 0 0 8 17 17 17 17 17 17 17 8
8 17 17 17 17 17 17 17 17 17 17 17 17 17 17 17 17 17 17 8 0 0 0 8 17 17 17 17 17 17 17 8
8 17 17 17 17 17 17 17 17 17 9 17 17 17 17 17 17 17 17 8 0 0 0 8 17 17 17 17 17 17 17 8
8 17 17 17 17 17 17 17 17 17 9 17 17 17 17 17 17 17 17 8 0 0 0 8 17 17 17 17 17 17 17 8
8 17 17 17 17 17 17 17 17 17 9 17 17 17 17 17 17 17 17 16 0 0 0 8 17 17 17 17 17 17 17 8
8 8 8 8 8 8 16 16 16 8 8 8 8 8 8 8 8 8 16 16 0 0 0 8 8 8 16 16 16 8 8 8
0 0 0 0 0 0 0 0 0 0 0 0 0 0 0 0 0 0 0 0 0 0 0 0 0 0 0 0 0 0 0 0
0 0 0 0 0 0 0 0 0 0 0 0 0 0 0 0 0 0 0 0 0 0 0 0 0 0 0 0 0 0 0 0
0 0 0 0 0 0 0 0 0 0 0 0 0 0 0 0 0 0 0 0 0 0 0 0 0 0 0 0 0 0 0 0
8 8 8 8 8 8 16 16 16 8 8 8 8 8 8 8 8 8 8 8 8 8 8 8 8 8 16 16 16 8 8 8
8 17 17 17 17 17 17 17 17 17 17 17 17 17 17 17 17 9 17 17 17 17 17 17 17 17 17 17 17 17 17 8
8 17 17 17 17 17 17 17 17 17 17 17 17 17 17 17 17 9 17 17 17 17 17 17 17 17 17 17 17 17 17 8
8 17 17 17 17 17 17 17 17 17 17 17 17 17 17 17 17 9 17 17 17 17 17 17 17 17 17 17 17 17 17 8
8 17 17 17 17 17 17 17 17 17 17 17 17 17 17 17 17 17 17 17 17 17 17 17 17 17 17 17 17 17 17 8
8 17 17 17 17 17 17 17 17 17 17 17 17 17 17 17 17 17 17 17 17 17 17 17 17 17 17 17 17 17 17 8
8 17 17 17 17 17 17 17 17 17 17 17 17 17 17 17 17 9 17 17 17 17 17 17 17 17 17 17 17 17 17 8
8 17 17 17 17 17 17 17 17 17 17 17 17 17 17 17 17 9 17 17 17 17 17 17 17 17 17 17 17 17 17 8
8 8 8 8 8 8 8 8 8 8 8 8 8 8 8 8 8 8 8 8 8 8 8 8 8 8 8 8 8 8 8 8
