10 10 10 21 21 21 0 4 4 4 0 8 8 8 8 0 0 0 0 0 0 0 0 0 0 0 0 0 0 0 0 0
10 10 10 10 21 17 7 7 7 4 4 15 17 17 15 7 4 4 4 4 0 0 0 0 0 0 0 0 0 0 0 0
10 10 10 10 17 17 17 21 21 21 21 8 17 17 8 4 5 7 7 7 4 0 0 0 0 0 0 0 0 0 0 0
21 21 10 17 17 17 10 10 10 10 21 8 8 8 8 4 4 4 4 4 4 7 7 4 0 0 0 0 0 0 0 0
21 21 17 17 17 10 10 10 10 10 10 10 10 10 10 21 21 21 0 0 0 4 5 5 4 0 0 0 0 21 21 21
0 4 5 17 21 10 10 10 10 10 10 10 10 10 10 10 10 21 21 21 0 0 4 4 7 4 0 0 21 21 10 10
0 4 5 4 0 21 9 21 21 21 10 10 10 10 10 10 10 10 10 21 21 0 0 0 4 4 4 0 21 10 10 10
4 7 4 4 0 21 21 21 21 21 21 21 21 10 10 10 10 10 10 10 10 21 21 21 21 4 7 17 10 10 10 10
4 4 7 4 4 0 8 8 8 8 21 21 21 21 27 8 10 10 10 10 10 10 10 21 21 21 17 17 17 10 10 10
4 7 4 7 7 4 15 17 17 8 0 0 0 0 6 8 8 8 21 10 10 10 10 10 10 10 10 17 17 17 10 10
4 5 7 4 4 4 15 17 17 8 0 0 8 6 7 8 8 8 21 21 10 10 10 10 10 10 10 10 17 17 17 21
4 4 7 4 0 0 8 8 8 8 27 8 8 8 7 0 6 8 21 21 21 10 10 10 10 10 10 10 10 17 7 0
0 4 7 4 0 0 0 0 0 0 0 8 8 8 8 7 6 0 0 0 2 21 21 10 10 10 10 21 21 4 4 4
0 4 5 4 0 0 0 0 0 0 6 7 27 0 6 6 0 0 0 0 5 5 21 21 21 21 21 21 8 0 4 4
0 8 15 15 8 0 0 0 0 6 7 7 6 6 0 0 0 0 0 8 6 5 2 0 0 0 0 8 4 7 4 4
0 8 17 17 8 0 0 0 0 8 8 7 6 0 0 0 0 0 8 5 6 6 5 0 0 0 0 4 7 7 4 4
0 8 17 17 8 0 0 0 8 8 8 8 0 0 0 0 0 0 0 0 5 5 4 0 0 0 0 0 4 4 7 4
0 8 15 8 8 0 0 0 8 8 8 0 0 0 0 0 0 0 0 0 0 6 4 0 8 8 8 8 0 0 5 4
0 0 0 0 0 0 0 0 8 8 8 0 0 0 0 0 0 0 0 0 0 4 4 8 8 17 17 8 8 0 4 7
0 0 0 0 0 0 0 8 8 8 27 0 0 0 0 0 1 8 8 0 0 4 7 8 17 17 17 17 8 0 0 5
0 0 0 0 0 0 6 7 7 7 6 0 0 0 0 0 8 14 14 8 0 4 0 8 17 17 17 17 8 0 4 7
0 0 0 0 0 0 0 7 7 7 6 0 0 0 0 8 14 14 14 14 8 4 4 8 8 15 15 8 8 0 5 7
0 0 0 0 0 0 6 0 27 7 6 0 0 0 0 8 14 14 14 17 17 5 4 4 0 15 15 4 4 4 7 4
0 0 0 0 0 0 0 7 7 7 8 0 0 0 0 0 8 14 14 17 7 7 7 4 4 5 4 4 4 4 4 0
0 0 0 0 0 0 0 6 8 8 8 8 0 0 0 0 0 8 8 5 4 5 5 7 4 4 5 7 7 7 4 0
0 0 0 0 0 0 0 6 7 8 8 8 0 0 0 0 0 0 0 0 8 8 8 8 7 7 7 7 5 5 0 0
0 0 0 0 0 0 0 0 7 8 8 6 0 0 0 0 0 0 0 0 8 17 17 15 5 5 5 4 0 0 0 0
0 0 0 0 0 0 0 0 6 6 7 6 0 0 0 0 0 8 8 8 17 17 17 15 4 0 4 0 0 0 0 0
0 0 0 0 0 0 0 0 27 6 7 27 0 0 0 0 0 15 17 17 17 17 17 8 0 0 0 0 0 0 0 0
0 0 0 0 0 0 0 0 6 6 6 6 0 0 0 0 0 15 17 17 17 17 17 8 0 0 0 0 0 0 0 0
0 0 0 0 0 0 0 0 0 6 7 6 0 0 0 0 0 8 8 8 8 8 8 0 0 0 0 0 0 0 0 0
0 0 0 0 0 0 0 0 0 6 7 7 0 0 0 0 0 0 0 0 9 9 0 0 0 0 0 0 0 0 0 0
