8 8 8 8 8 8 8 5 6 6 6 5 5 4 3 2 0 9 3 4 5 5 9 9 5 5 4 3 9 9 0 0
8 17 17 17 17 17 15 5 6 7 6 9 5 4 3 2 0 9 3 4 5 6 6 7 9 5 4 3 0 0 0 0
8 17 17 17 17 8 8 5 6 6 6 9 5 4 3 2 0 9 3 4 5 6 7 7 9 5 4 3 0 0 9 0
8 17 17 17 8 8 4 5 5 5 21 21 21 9 3 2 0 3 3 4 9 6 7 7 6 5 4 9 0 0 9 0
8 15 15 8 21 21 21 5 21 21 21 21 21 21 21 21 9 3 9 9 9 9 9 9 9 9 9 3 0 0 0 0
0 0 0 27 21 21 21 21 21 21 21 10 10 21 21 21 21 21 19 19 19 19 19 19 19 19 8 8 8 8 15 8
0 0 0 0 9 21 21 10 9 10 10 10 10 10 10 21 21 21 19 19 19 19 19 19 19 19 15 17 17 17 17 8
0 27 0 0 0 21 21 21 10 10 10 10 10 10 10 21 21 0 9 0 0 0 0 0 0 9 8 17 17 17 17 8
27 0 0 0 0 21 21 21 21 10 10 10 10 10 21 21 0 0 0 0 0 0 0 0 0 9 8 8 17 17 17 8
0 0 8 8 8 8 21 21 21 10 10 10 10 21 21 9 14 14 14 14 14 14 14 9 0 0 0 8 8 17 17 8
0 0 8 17 17 8 0 0 21 21 10 10 10 21 21 14 14 14 14 14 14 14 14 14 0 0 0 0 8 8 15 8
27 27 8 15 8 8 0 0 21 21 21 10 10 21 21 9 8 8 8 8 15 8 14 14 0 9 9 0 0 27 19 19
0 0 0 19 0 0 0 27 0 21 21 10 10 21 21 21 8 17 17 17 17 8 14 9 2 2 2 27 2 2 19 19
27 0 0 19 9 0 9 0 0 9 21 10 10 9 21 21 8 17 17 17 17 8 14 14 3 27 3 3 3 2 19 19
0 0 0 19 19 19 19 17 17 17 17 17 17 17 17 17 15 17 17 17 17 8 14 14 3 4 4 4 3 2 19 19
0 3 3 3 3 3 3 17 17 17 17 17 17 17 17 17 15 17 17 17 17 8 14 14 27 4 5 4 27 2 19 19
0 3 4 4 9 4 9 17 17 9 21 10 10 9 21 21 8 17 17 17 17 8 14 14 2 4 4 4 3 2 19 19
27 3 4 27 5 5 5 17 17 21 21 10 10 21 21 21 8 8 8 8 15 8 14 14 2 3 3 3 3 2 19 19
0 3 4 5 5 6 6 17 17 21 21 21 10 10 21 21 21 21 9 14 14 14 14 14 2 2 9 9 9 9 9 9
0 3 4 5 6 6 7 17 17 21 21 21 10 10 21 21 21 21 14 14 14 14 14 14 27 0 14 14 8 8 8 8
0 3 4 5 9 6 7 17 17 21 21 21 10 10 10 21 21 21 9 14 14 14 14 9 5 5 14 14 15 17 17 8
0 8 8 8 8 8 6 17 17 6 6 21 21 10 10 10 21 21 21 0 3 4 5 6 6 6 14 14 8 17 17 8
0 8 17 17 17 8 5 17 17 6 7 6 21 21 10 10 10 21 21 21 21 4 5 9 9 7 14 14 8 17 17 8
0 8 17 17 17 8 9 17 17 9 6 6 5 21 21 10 10 10 10 21 21 21 5 6 7 7 14 14 8 17 17 8
0 8 17 17 17 15 17 17 17 17 17 17 17 17 17 21 21 10 10 10 21 4 5 6 27 7 14 14 8 17 17 8
0 8 17 17 17 15 17 17 17 17 17 17 17 17 17 21 21 21 21 21 21 21 27 6 6 6 14 14 8 15 15 8
0 8 17 17 17 8 0 0 0 0 0 0 9 17 17 0 0 21 21 21 21 9 5 27 5 5 9 9 9 17 17 9
0 8 17 17 17 8 8 8 8 8 0 27 0 17 17 9 0 0 0 0 9 9 4 4 9 4 4 4 4 17 17 0
0 8 17 17 17 17 17 17 17 15 0 0 0 17 17 9 9 9 0 0 3 3 3 3 3 3 3 3 3 17 17 0
0 15 17 17 17 17 17 17 17 15 0 9 9 17 17 17 17 17 17 17 17 17 17 17 17 17 17 17 17 17 17 17
0 8 8 8 8 8 8 8 8 8 0 0 0 17 17 17 17 17 17 17 17 17 17 17 17 17 17 17 17 17 17 17
0 0 0 0 0 0 0 0 0 0 0 0 0 9 9 9 0 0 0 0 0 0 0 0 9 0 0 0 0 9 9 0
