8 8 8 8 8 8 8 8 0 0 9 0 9 9 0 0 0 0 9 0 9 9 9 9 0 27 0 0 9 0 0 27
8 17 17 17 17 17 17 8 0 0 0 0 0 0 0 0 9 0 0 0 9 0 0 0 0 0 9 0 9 0 9 0
8 17 17 17 17 9 17 8 9 0 9 9 9 9 9 9 9 27 9 0 0 0 0 0 0 0 0 0 27 0 9 0
8 17 9 17 17 17 17 8 0 0 9 0 0 9 27 0 0 0 9 0 9 9 9 9 9 9 0 0 0 0 9 0
8 17 17 17 9 17 17 15 0 0 9 0 0 0 0 0 0 0 9 0 9 0 0 0 27 0 0 0 0 0 9 0
8 9 17 17 9 17 17 15 0 0 9 0 9 0 0 0 9 0 9 0 9 0 0 0 0 0 9 9 0 0 9 0
8 17 17 17 17 17 8 8 9 15 9 9 9 15 15 9 9 9 9 9 9 9 9 0 0 0 0 0 0 0 0 0
8 17 17 9 17 17 15 0 0 0 0 0 0 0 0 0 0 0 0 0 0 0 9 0 0 0 0 0 9 9 0 0
8 8 8 8 8 8 8 2 3 3 3 3 3 3 3 3 3 3 3 3 3 2 15 0 0 0 0 0 0 0 0 0
27 0 9 9 0 0 9 2 3 4 4 4 4 4 4 4 4 4 4 4 3 2 9 3 3 3 3 3 3 9 9 0
0 0 0 0 0 27 15 2 3 4 5 5 5 5 5 5 5 5 5 4 3 0 9 4 4 4 4 4 3 9 0 0
0 27 9 9 0 0 9 2 3 4 5 6 6 6 6 6 6 6 5 4 3 2 9 5 5 5 5 4 3 9 0 0
0 0 9 9 27 0 9 2 3 4 5 6 7 7 7 7 7 6 5 4 3 0 9 6 6 6 5 4 3 9 0 9
0 0 0 0 0 0 15 0 3 4 5 6 7 7 7 7 7 6 5 4 3 0 15 6 7 6 5 4 3 9 0 0
27 0 0 0 0 0 15 2 3 4 5 6 7 7 32 7 7 6 5 4 3 2 15 6 7 6 5 4 3 9 0 0
0 8 8 8 8 8 9 2 3 4 5 6 7 7 7 7 7 6 5 4 3 0 9 6 6 6 5 4 3 9 0 0
0 8 17 17 17 8 9 2 3 4 5 6 7 7 7 7 7 6 5 4 3 2 9 5 5 5 5 4 3 9 0 0
0 8 17 17 17 15 15 2 3 4 5 6 6 6 6 6 6 6 5 4 3 2 9 4 4 4 4 4 3 9 0 9
0 8 17 17 17 15 15 2 3 4 5 5 5 5 5 5 5 5 5 4 3 0 9 3 3 3 3 3 3 9 0 0
0 8 8 8 8 8 9 0 3 4 4 4 4 4 4 4 4 4 4 4 3 2 9 27 2 0 2 0 0 0 0 27
0 9 0 0 0 9 9 2 3 3 3 3 3 3 3 3 3 3 3 3 3 0 9 0 0 0 0 9 0 0 9 0
0 0 0 0 0 0 15 0 0 0 0 0 0 0 0 0 0 0 0 0 0 0 15 0 0 0 0 8 15 15 8 2
0 0 0 0 27 0 15 15 9 9 9 9 9 9 9 15 15 9 9 9 9 9 9 0 0 0 8 8 17 17 8 2
27 0 9 9 0 0 4 5 9 4 4 4 9 0 0 27 0 9 0 9 0 0 0 0 0 8 8 17 17 17 8 2
0 0 9 9 0 27 27 5 4 5 5 5 9 27 0 0 0 0 0 0 0 0 0 0 8 8 17 17 17 17 8 2
0 0 0 0 0 0 4 5 9 5 9 6 9 0 0 0 0 9 0 0 0 0 0 8 8 17 17 17 9 9 8 2
0 0 0 0 9 9 4 5 4 5 6 7 9 0 0 0 0 0 27 0 9 0 0 8 17 17 17 17 17 17 8 3
8 15 8 8 8 8 4 27 5 9 6 7 9 9 9 9 0 0 9 0 0 9 0 8 17 17 9 9 17 17 8 4
8 17 17 17 17 8 0 4 5 9 9 7 6 5 4 5 4 27 27 0 0 0 9 8 17 17 17 17 17 17 15 5
8 17 17 17 17 8 0 27 5 5 9 9 9 9 4 27 4 0 0 0 27 0 0 15 17 17 17 9 17 8 8 6
8 17 17 17 17 15 0 0 4 4 4 4 4 4 5 4 0 0 9 0 0 0 0 15 15 8 8 8 8 8 7 7
8 8 8 8 8 8 0 0 0 0 9 0 0 0 4 0 0 0 9 0 0 0 0 0 0 9 3 4 5 6 7 7
