8 8 8 8 8 8 21 21 21 21 21 21 21 10 10 21 21 21 21 9 21 21 21 9 21 9 7 7 7 7 7 7
8 17 17 17 17 8 21 21 21 9 21 21 21 10 10 21 21 21 21 21 5 6 7 7 6 5 7 2 2 2 2 7
8 17 17 17 17 8 21 21 11 11 21 21 9 21 21 9 21 21 21 9 4 9 7 7 6 5 7 2 2 2 2 2
8 17 17 17 17 8 21 21 11 11 21 21 21 21 21 0 0 0 3 4 5 6 7 7 6 5 7 4 27 4 3 2
8 8 15 15 8 8 21 21 11 11 11 21 21 21 21 0 0 27 3 4 5 6 7 7 7 6 27 5 4 27 3 2
2 9 5 5 9 3 21 21 21 11 11 21 21 21 21 0 9 9 3 9 9 6 7 9 7 6 6 5 5 4 9 2
2 6 6 5 4 3 2 21 21 10 11 9 9 9 9 21 21 9 3 9 9 6 6 7 7 7 6 6 5 4 3 2
2 7 6 5 4 3 17 17 17 17 17 17 17 17 9 21 21 9 3 4 5 27 6 6 7 7 7 6 5 27 9 2
2 7 6 5 9 9 17 17 17 17 17 17 17 17 9 21 21 9 3 4 5 4 5 6 6 7 7 6 27 4 3 2
2 7 6 5 4 7 9 21 21 11 11 12 17 17 11 10 10 21 21 21 4 4 5 9 6 6 6 6 5 4 3 2
2 7 6 27 4 3 2 21 21 21 11 11 17 17 11 10 10 10 10 21 21 21 21 9 5 27 5 5 5 4 27 2
2 7 6 5 4 27 4 5 5 21 21 21 17 17 11 10 10 10 10 10 10 10 10 7 7 4 5 5 4 4 3 9
2 7 6 5 4 3 4 5 6 6 6 21 17 17 21 21 21 8 8 8 8 8 8 7 7 4 4 4 4 4 4 4
2 6 6 27 4 3 4 27 6 7 9 0 17 17 7 7 7 8 17 17 17 17 8 7 7 7 3 4 9 9 5 5
2 5 5 5 4 9 9 5 6 6 9 0 17 17 9 9 9 8 17 17 17 17 8 7 7 7 0 4 5 6 6 6
2 4 4 4 4 3 4 5 5 5 9 0 17 17 17 17 17 15 17 17 17 17 8 7 7 7 0 4 5 6 7 7
2 9 9 9 3 3 4 4 9 7 7 7 17 17 17 17 17 15 17 17 17 17 8 7 7 7 0 4 5 9 7 9
2 17 17 17 17 17 17 17 17 17 17 17 17 17 9 9 9 8 17 17 17 17 8 9 9 9 0 8 8 8 15 8
9 17 17 17 17 9 17 9 17 17 17 17 17 17 7 7 7 8 8 8 8 8 8 2 0 2 2 8 17 17 17 8
8 15 15 8 8 8 15 8 8 8 8 8 17 17 6 6 6 5 4 3 3 3 9 9 9 3 2 8 17 17 17 8
8 17 17 17 17 8 4 4 27 4 4 8 17 17 5 5 9 4 9 4 4 4 9 9 9 3 9 15 17 17 17 8
8 17 17 17 17 8 5 5 5 5 27 8 17 17 4 4 9 4 5 5 5 5 5 5 4 3 2 15 17 17 17 8
8 17 17 9 17 8 6 27 6 5 4 8 17 17 9 9 9 4 5 6 6 6 27 5 4 3 9 8 8 15 8 8
8 17 17 17 17 8 6 7 6 5 4 8 17 17 0 2 9 4 5 27 7 7 6 27 4 3 0 8 17 17 17 8
8 17 9 17 17 8 6 6 6 5 4 15 17 17 0 2 9 4 5 6 7 27 6 5 4 9 2 8 17 17 17 8
8 17 17 9 17 8 15 15 8 8 8 8 17 17 9 2 3 4 9 6 6 6 6 5 4 9 0 8 17 17 17 8
8 17 9 17 17 17 17 17 9 17 17 8 17 17 9 2 3 4 5 5 5 5 5 5 4 3 2 8 17 17 17 8
8 17 17 17 17 17 9 9 17 17 17 8 17 17 0 2 9 4 4 3 9 3 9 3 3 3 2 8 17 17 17 8
8 9 9 17 17 17 17 17 17 17 17 8 17 17 0 0 9 4 4 3 3 3 9 3 9 8 8 8 17 17 17 8
8 17 17 17 17 9 17 17 9 17 17 15 17 17 17 17 17 17 17 17 17 17 17 17 17 15 17 17 17 17 17 8
8 17 17 9 17 9 17 17 9 17 17 15 17 17 17 17 17 17 17 17 17 17 17 17 17 15 17 17 17 17 17 8
8 8 8 8 8 8 8 8 8 8 8 8 0 0 0 0 0 2 2 2 2 2 2 2 9 8 8 8 8 8 8 8
