0 0 0 0 0 0 0 0 0 0 0 0 0 0 0 0 0 0 0 0 0 0 0 0 0 0 0 0 0 0 0 0
0 0 0 0 0 0 0 0 0 0 0 0 0 0 0 0 0 0 0 0 0 0 0 0 0 0 0 0 0 0 0 0
0 0 0 0 0 0 0 0 0 0 0 0 0 0 0 17 17 17 0 0 0 0 0 0 0 0 0 0 0 0 0 0
0 0 0 0 0 0 0 0 10 10 10 10 10 10 10 17 17 17 10 10 10 10 10 10 10 0 0 0 0 0 0 0
0 0 0 0 0 0 0 10 10 10 10 10 10 10 10 17 17 17 10 10 10 10 10 10 10 10 0 0 0 0 0 0
0 0 0 0 0 0 0 10 10 0 0 0 0 0 0 17 17 17 0 0 0 0 0 0 10 10 0 0 0 0 0 0
0 0 0 0 0 0 10 10 0 0 0 0 0 0 0 0 0 0 0 0 0 0 0 0 0 10 10 0 0 0 0 0
0 0 0 0 0 10 10 0 0 8 0 8 0 8 0 0 0 0 0 8 0 8 0 8 0 10 10 10 0 0 0 0
0 0 0 0 0 10 10 0 0 0 8 8 8 0 0 0 0 0 0 0 8 8 8 0 0 0 10 10 0 0 0 0
0 0 0 0 0 10 10 0 0 8 8 8 8 8 8 15 15 15 8 8 8 8 8 8 0 0 10 10 0 0 0 0
0 0 0 0 0 10 10 0 0 0 8 8 8 8 8 15 15 15 8 8 8 8 8 0 0 0 10 10 0 0 0 0
0 0 0 0 0 10 10 0 0 8 0 8 8 17 17 17 17 17 17 17 8 8 0 8 0 0 10 10 0 0 0 0
0 0 0 0 0 10 10 0 0 0 0 8 8 17 17 17 17 17 17 17 8 8 0 0 0 0 10 10 0 0 0 0
0 0 0 0 17 17 17 17 0 0 0 8 8 17 17 17 17 17 17 17 8 8 0 0 0 17 17 17 17 0 0 0
0 0 0 0 17 17 17 17 0 0 0 8 8 17 17 17 17 17 17 17 8 8 0 0 0 17 17 17 17 0 0 0
0 0 0 0 0 10 10 0 0 0 0 8 8 17 17 17 17 17 17 17 8 8 0 0 0 0 10 10 0 0 0 0
0 0 0 0 0 10 10 0 0 8 0 8 8 17 17 17 17 17 17 17 8 8 0 8 0 0 10 10 0 0 0 0
0 0 0 0 0 10 10 0 0 0 8 8 8 8 8 8 8 8 8 8 8 8 8 0 0 0 10 10 0 0 0 0
0 0 0 0 0 10 10 0 0 8 8 8 8 8 8 8 8 8 8 8 8 8 8 8 0 0 10 10 0 0 0 0
0 0 0 0 0 10 10 0 0 0 8 8 8 0 0 0 0 0 0 0 8 8 8 0 0 0 10 10 0 0 0 0
0 0 0 0 0 10 10 0 0 8 0 8 0 8 0 0 0 0 0 8 0 8 0 8 0 0 10 10 0 0 0 0
0 0 0 0 0 10 10 10 0 0 0 0 0 0 0 0 0 0 0 0 0 0 0 0 0 0 10 10 0 0 0 0
0 0 0 0 0 0 10 10 10 0 0 0 0 0 0 0 0 0 0 0 0 0 0 0 0 10 10 10 0 0 0 0
0 0 0 0 0 0 0 10 10 10 0 0 0 0 0 17 17 17 0 0 0 0 0 0 10 10 10 0 0 0 0 0
0 0 0 0 0 0 0 0 10 10 10 10 10 10 10 17 17 17 10 10 10 10 10 10 10 10 0 0 0 0 0 0
0 0 0 0 0 0 0 0 0 10 10 10 10 10 10 17 17 17 10 10 10 10 10 0 0 0 0 0 0 0 0 0
0 0 0 0 0 0 0 0 0 0 0 0 0 0 0 17 17 17 0 0 0 0 0 0 0 0 0 0 0 0 0 0
0 0 0 0 0 0 0 0 0 0 0 0 0 0 0 0 0 0 0 0 0 0 0 0 0 0 0 0 0 0 0 0
0 0 0 0 0 0 0 0 0 0 0 0 0 0 0 0 0 0 0 0 0 0 0 0 0 0 0 8 8 8 8 8
0 0 0 0 0 0 0 0 0 0 0 0 0 0 0 0 0 0 0 0 0 0 0 0 0 0 0 15 17 17 17 8
0 0 0 0 0 0 0 0 0 0 0 0 0 0 0 0 0 0 0 0 0 0 0 0 0 0 0 15 17 17 17 8
0 0 0 0 0 0 0 0 0 0 0 0 0 0 0 0 0 0 0 0 0 0 0 0 0 0 0 8 8 8 8 8
