9 9 9 9 9 0 0 0 0 0 0 8 8 8 8 8 8 8 0 0 0 0 0 0 0 0 0 0 0 8 8 8
9 14 14 14 9 0 0 0 0 8 8 8 8 8 0 0 8 8 8 0 0 0 0 0 0 0 0 0 0 8 8 8
9 14 14 14 9 0 0 0 0 8 8 8 8 8 0 0 0 8 8 0 0 0 0 0 0 0 0 0 0 8 8 8
9 14 14 14 9 0 0 0 0 8 8 0 8 8 0 0 0 8 8 0 0 0 0 0 8 8 0 0 0 8 8 8
9 9 16 9 9 0 0 0 8 8 0 0 0 8 8 0 0 0 8 0 0 0 0 0 8 8 8 0 0 0 8 0
0 0 0 0 0 0 0 0 8 8 0 0 0 8 8 8 8 0 0 0 0 0 0 8 8 8 8 8 0 0 0 0
0 0 0 0 0 0 0 0 8 8 0 0 0 0 8 8 8 8 0 0 0 0 8 8 8 8 0 0 0 0 0 0
0 0 0 0 0 0 0 0 8 8 8 0 0 0 8 8 8 0 0 0 0 8 8 8 8 0 0 0 0 0 0 0
0 0 0 0 0 0 0 8 8 8 8 0 0 0 0 8 0 0 0 0 8 8 8 8 0 0 0 0 0 0 0 0
0 0 0 0 0 0 8 8 8 8 8 8 0 0 0 0 0 0 0 0 8 8 8 0 0 0 0 0 0 0 0 0
0 0 0 0 8 8 8 0 0 8 8 0 0 0 0 8 0 0 0 0 8 8 8 8 0 0 0 0 0 0 0 0
0 0 0 8 8 8 8 0 0 0 8 8 0 0 8 8 8 0 0 0 0 8 8 8 8 0 0 0 0 0 0 0
0 0 0 0 8 8 8 8 0 0 8 0 0 8 8 8 0 0 0 0 0 0 8 8 8 0 0 8 8 0 0 0
0 0 0 0 0 0 0 8 8 0 0 0 0 8 8 8 0 0 0 0 0 0 8 8 8 0 0 8 8 0 0 0
0 0 0 0 0 0 0 8 8 8 0 0 0 0 8 8 0 0 0 0 0 8 8 8 0 0 0 8 8 0 0 0
0 0 0 0 0 0 8 8 8 0 0 0 0 8 8 0 0 0 0 0 8 8 8 0 0 0 8 8 8 8 0 0
0 0 0 0 0 0 8 8 0 0 0 8 8 8 0 0 0 0 0 0 8 8 8 0 0 0 8 8 8 0 0 0
0 0 0 0 0 0 0 0 0 0 8 8 8 8 0 8 0 0 0 0 8 8 8 0 0 0 8 8 8 0 0 0
0 0 0 0 0 0 0 0 0 8 8 8 8 8 8 8 0 0 8 8 8 8 0 0 0 0 0 0 0 0 0 0
0 0 0 0 0 0 0 8 8 8 8 0 8 8 8 0 0 8 8 8 8 8 0 0 0 0 0 0 0 0 0 0
0 0 0 0 0 0 8 8 8 8 0 0 0 0 0 0 0 0 8 8 8 8 8 0 0 0 0 0 0 0 0 0
0 0 0 0 0 8 8 8 8 0 0 0 0 0 0 0 8 0 0 8 8 8 8 0 0 0 0 0 0 0 0 0
8 8 0 0 0 8 8 8 8 0 0 0 0 0 0 8 8 0 0 8 8 8 8 8 0 0 0 0 0 0 0 0
8 8 8 0 0 0 8 8 8 0 0 0 0 0 8 8 8 0 0 0 8 8 8 8 0 0 0 0 0 0 0 0
8 8 8 0 0 0 8 0 8 8 0 0 0 0 8 8 8 8 0 0 8 8 8 8 0 0 0 0 0 0 0 0
8 8 8 8 0 0 0 0 8 8 8 0 0 0 0 8 8 8 8 8 8 8 8 8 8 0 0 0 0 0 0 0
8 8 8 0 0 0 0 0 8 8 8 0 0 0 0 8 8 8 8 8 8 8 8 8 8 0 0 9 9 16 9 9
0 0 0 0 0 0 0 0 0 8 0 0 0 0 0 0 0 0 8 8 8 8 8 8 0 0 0 9 14 14 14 9
0 0 0 0 0 0 0 0 0 0 0 0 0 0 0 0 0 0 0 8 8 8 8 0 0 0 0 9 14 14 14 9
0 0 0 0 0 0 0 0 0 0 0 0 0 0 0 0 0 0 8 8 8 8 8 0 0 0 0 9 14 14 14 9
0 0 0 0 0 0 0 0 8 8 8 0 0 0 0 0 0 0 0 8 8 8 0 0 0 0 0 9 9 9 9 9
