0 0 0 0 0 0 0 0 0 0 9 9 9 9 9 9 9 9 0 0 0 0 0 0 0 0 0 0 0 0 0 0
0 9 0 0 27 0 0 0 0 0 27 0 0 0 0 0 0 0 0 0 0 0 0 0 0 0 0 0 0 0 0 0
0 9 0 0 0 0 0 0 0 0 0 0 0 0 0 0 0 0 0 0 0 0 0 0 0 0 0 0 0 0 0 0
0 9 0 0 0 0 0 9 9 9 9 9 0 0 0 0 27 9 9 9 0 0 0 9 9 9 9 9 0 0 0 0
0 9 0 0 0 0 0 0 0 0 0 0 0 0 0 0 0 0 0 0 0 0 0 0 0 0 9 9 0 0 0 0
0 9 0 0 9 0 0 0 0 0 0 0 0 0 0 0 0 0 0 0 0 0 0 0 0 0 0 9 0 27 0 0
0 9 0 0 9 0 0 9 9 9 9 9 9 9 9 9 9 0 0 0 0 9 9 9 9 0 0 9 0 0 0 0
0 9 0 0 0 0 0 9 9 0 0 0 0 0 0 0 0 0 0 0 0 0 0 0 9 0 0 9 0 0 0 0
0 0 0 0 0 0 0 9 9 0 0 0 0 0 0 0 0 0 0 0 0 0 27 0 0 0 0 9 0 0 0 0
0 0 0 0 0 0 0 9 0 0 9 9 9 9 9 0 0 0 9 9 9 9 0 0 0 0 0 9 0 0 0 0
0 27 0 0 9 0 0 9 0 0 9 0 0 0 0 0 0 0 0 0 0 9 0 0 9 0 0 0 0 0 0 0
0 0 0 0 0 0 0 9 0 0 0 0 0 0 0 0 0 0 0 0 0 9 0 0 9 0 0 0 0 0 0 0
0 0 0 0 9 0 0 9 0 0 0 0 0 9 0 0 0 9 9 0 0 9 0 0 9 0 0 0 27 0 0 0
0 0 0 0 9 0 0 0 0 0 0 0 0 9 0 27 0 0 9 0 0 9 0 0 9 0 0 0 0 0 0 0
0 0 0 0 9 0 0 0 0 0 9 27 0 9 0 0 0 0 0 0 0 9 0 0 0 0 0 9 0 0 0 0
0 0 0 0 9 0 0 0 0 0 9 0 0 9 0 0 0 0 0 0 0 0 0 0 0 0 0 9 0 0 0 0
0 0 0 0 9 27 0 0 0 0 0 0 0 9 0 0 0 0 9 0 0 0 0 0 0 0 0 9 0 0 0 0
0 9 27 0 9 0 0 9 0 0 0 0 0 9 9 0 0 9 9 0 0 0 0 0 9 0 0 9 0 0 0 0
0 9 0 0 0 0 0 0 0 27 0 0 0 0 0 0 0 0 0 0 0 9 0 0 9 0 0 9 0 0 27 0
0 9 0 0 0 0 0 0 0 0 0 0 0 0 0 0 0 0 0 0 0 9 0 0 9 0 0 9 0 0 0 0
0 9 0 0 0 0 0 0 0 0 0 9 9 9 9 9 0 0 0 9 9 9 0 0 0 0 0 9 0 0 0 0
0 9 0 0 0 0 0 0 0 0 0 0 0 0 0 0 0 0 0 0 0 0 0 0 0 0 0 9 0 0 0 0
0 0 0 0 0 27 0 0 0 0 0 0 0 0 0 0 0 0 0 9 0 0 0 0 9 0 0 9 0 0 0 0
0 27 0 0 9 0 0 9 0 0 9 9 9 0 0 0 9 9 9 9 0 0 0 9 9 0 0 9 0 0 27 0
0 0 0 9 9 0 0 0 0 0 0 0 0 0 0 0 0 0 0 0 0 0 0 0 0 0 0 9 0 0 0 0
0 0 0 9 9 0 0 0 0 0 0 0 0 0 0 0 0 0 0 0 0 0 0 9 9 27 0 9 0 0 0 0
0 0 0 0 9 0 0 0 0 27 0 0 9 9 9 9 9 9 9 9 9 0 0 9 9 0 0 9 0 0 0 0
0 0 0 0 0 0 0 0 0 0 0 0 0 0 0 0 0 0 0 0 0 0 0 0 0 0 0 0 0 0 0 0
0 0 0 0 0 0 0 0 0 0 0 0 0 0 0 27 0 0 0 27 0 0 0 0 0 0 0 0 0 0 0 0
0 9 9 9 9 0 0 9 9 9 9 0 0 0 0 0 0 0 0 0 0 0 9 9 9 9 0 0 0 0 0 0
0 0 0 0 0 0 0 0 0 0 0 0 0 0 0 0 0 0 0 0 0 0 0 0 0 0 0 0 0 0 0 0
0 0 0 0 0 0 0 0 0 0 0 0 0 0 0 0 0 0 0 0 0 0 0 0 0 0 0 0 0 0 0 0
