27 0 27 0 0 0 27 0 0 0 0 0 0 0 8 8 8 8 8 8 8 8 0 0 0 0 0 8 8 8 8 8
0 0 0 0 0 0 0 0 27 0 0 0 0 0 8 17 17 17 17 17 17 8 4 3 3 3 0 8 17 17 17 8
0 0 0 0 27 0 0 0 0 0 0 0 0 0 8 17 17 17 17 17 17 16 5 5 3 4 5 16 17 17 17 8
27 0 0 27 0 0 0 0 0 27 3 3 3 3 8 17 17 17 17 17 17 16 3 4 4 4 3 16 17 17 17 8
0 0 27 27 0 0 0 0 3 3 4 4 4 4 8 8 8 8 8 8 8 8 3 6 6 6 0 8 8 8 8 8
0 0 0 0 3 3 3 3 0 4 4 0 0 5 5 5 5 5 5 0 3 3 4 3 7 3 3 0 0 0 0 0
0 0 3 3 0 5 5 5 5 5 5 0 5 5 3 3 0 0 3 3 3 0 3 5 6 6 6 0 0 0 0 0
0 0 3 5 5 5 0 3 3 3 3 3 3 0 0 0 0 0 0 0 0 0 3 3 5 3 3 0 0 0 0 0
0 27 3 0 3 3 3 0 0 21 21 21 21 21 21 21 21 21 21 21 21 21 21 17 17 17 21 21 21 21 21 0
4 4 3 3 3 0 21 21 21 21 10 10 10 10 10 10 10 10 21 21 21 21 21 17 17 17 21 21 21 21 21 21
4 5 0 3 21 21 21 21 10 10 10 10 10 10 10 10 10 10 10 10 10 10 10 17 17 17 10 10 10 10 10 10
3 5 3 3 21 21 21 10 10 10 10 10 10 10 10 10 10 10 10 10 10 10 10 17 17 17 10 10 10 10 10 10
3 5 3 21 21 21 10 10 10 10 10 10 10 10 10 10 10 10 10 10 10 10 10 17 17 17 10 10 10 10 10 10
0 5 3 21 21 21 10 10 10 10 10 10 10 21 21 21 21 21 21 21 21 21 21 17 17 17 21 10 10 10 10 10
4 5 3 21 21 21 10 10 10 10 10 10 21 21 21 21 21 21 21 21 21 21 21 17 17 17 21 21 21 21 21 21
4 3 0 21 21 10 10 10 10 10 10 21 21 21 21 0 0 0 0 0 0 0 0 0 7 21 21 21 21 21 21 21
4 3 0 21 21 10 10 10 10 10 21 21 0 0 8 8 8 8 8 8 8 8 8 0 7 0 8 8 8 8 8 8
4 3 3 21 21 10 10 10 10 10 21 0 0 0 8 17 17 17 17 17 17 17 8 6 7 6 8 17 17 17 17 8
5 0 0 21 21 10 10 10 10 10 21 0 0 0 8 17 17 17 17 17 17 17 16 4 6 4 16 17 17 17 17 8
5 4 3 21 21 10 10 10 10 21 21 0 0 0 8 17 17 17 17 17 17 17 16 4 6 4 16 17 17 17 17 8
0 4 0 21 21 10 10 10 10 21 21 0 0 0 8 17 17 17 17 17 17 17 16 5 4 4 16 17 17 17 17 8
3 4 0 21 21 10 10 10 10 21 21 0 0 0 8 17 17 17 17 17 17 17 8 0 6 4 8 17 17 17 17 8
0 4 3 21 21 10 10 10 10 21 21 3 3 0 8 8 8 16 16 16 8 8 8 6 6 0 8 8 8 8 8 8
4 5 5 17 17 17 17 17 17 17 17 4 4 4 4 5 5 0 5 0 3 3 3 6 4 6 0 5 5 0 3 3
5 5 0 17 17 17 17 17 17 17 17 6 6 6 6 5 6 5 6 5 5 6 5 3 4 6 0 5 5 5 6 6
0 5 4 17 17 17 17 17 17 17 17 4 0 5 5 5 0 3 3 0 5 5 5 3 3 7 3 3 5 0 4 0
3 3 0 0 21 21 10 10 10 21 21 21 3 0 8 8 8 16 16 16 8 8 8 4 6 0 8 8 16 16 8 8
0 0 0 0 21 21 10 10 10 21 21 21 0 0 8 17 17 17 17 17 17 17 8 4 6 0 8 17 17 17 17 8
0 0 0 0 21 21 10 10 10 21 21 21 0 0 8 17 17 17 17 17 17 17 16 4 4 0 16 17 17 17 17 8
0 0 0 0 21 21 10 10 10 10 21 21 0 0 8 17 17 17 17 17 17 17 16 0 6 4 16 17 17 17 17 8
0 0 0 0 21 21 10 10 10 10 21 21 0 0 8 17 17 17 17 17 17 17 8 0 6 3 8 17 17 17 17 8
0 0 0 0 21 21 21 10 10 10 21 21 0 0 8 8 8 8 8 8 8 8 8 0 4 0 8 8 8 8 8 8
