9 9 9 9 9 9 9 9 9 9 9 9 9 9 9 9 9 9 9 9 9 9 9 9 9 9 9 9 9 9 9 9
9 17 17 17 17 17 17 17 17 17 17 17 17 9 9 5 5 9 9 17 17 17 17 17 17 17 17 17 17 17 17 9
9 17 11 11 11 21 21 11 11 11 21 17 17 9 4 6 6 4 9 17 11 11 11 21 21 11 11 21 17 17 17 9
9 17 11 12 12 21 21 12 12 11 21 17 17 0 4 5 5 4 0 17 11 12 12 21 21 12 12 21 17 17 17 9
9 17 11 12 12 21 21 12 12 11 21 17 17 0 3 4 4 3 0 17 11 12 12 21 21 12 12 21 17 17 17 9
9 17 11 11 11 21 21 11 11 11 21 17 17 0 3 4 4 3 0 17 11 11 11 21 21 11 11 21 17 17 17 9
9 17 17 17 17 17 17 17 17 17 17 17 17 0 0 3 3 0 0 17 17 17 17 17 17 17 17 17 17 17 17 9
9 8 8 8 8 8 8 8 8 8 8 8 8 8 0 9 9 0 8 8 8 8 8 8 8 8 8 8 8 8 8 9
9 8 15 15 15 15 15 8 8 8 8 8 8 8 0 9 9 0 8 8 15 15 15 15 15 8 8 8 8 8 8 9
9 8 5 5 5 27 5 4 3 3 4 5 6 5 0 9 9 0 5 5 5 27 5 5 5 5 5 4 3 3 3 9
9 8 4 4 4 4 4 4 3 3 4 5 6 5 0 9 9 0 4 4 4 4 4 4 4 4 4 3 3 3 3 9
9 9 9 4 4 4 9 9 9 9 4 5 6 5 9 9 9 9 4 4 4 4 9 9 9 9 9 3 3 3 3 9
9 17 9 4 5 5 17 17 17 9 4 5 6 5 17 17 17 9 4 5 5 5 17 17 17 9 4 4 4 9 17 9
9 17 9 4 6 6 17 17 17 9 4 6 7 5 17 17 17 9 4 6 6 6 17 17 17 9 4 4 4 9 17 9
9 17 0 3 6 7 17 17 17 0 3 6 7 5 17 17 17 0 3 6 7 7 17 17 17 0 3 3 3 0 17 9
9 17 0 2 6 7 17 17 17 0 2 6 7 5 17 17 17 0 2 6 7 7 17 17 17 0 2 2 2 0 17 9
9 17 9 2 6 7 17 17 17 9 2 6 7 5 17 17 17 9 2 6 7 7 17 17 17 9 2 2 2 9 17 9
9 17 9 2 5 6 17 17 17 9 2 5 6 5 17 17 17 9 2 5 6 6 17 17 17 9 2 2 2 9 17 9
9 17 9 2 5 5 17 17 17 9 2 5 5 5 17 17 17 9 2 5 5 5 17 17 17 9 2 2 2 9 17 9
9 17 0 2 4 4 17 17 17 0 2 4 4 4 17 17 17 0 2 4 4 4 17 17 17 0 2 2 2 0 17 9
9 17 0 3 3 3 17 17 17 0 3 3 3 3 17 17 17 0 3 3 3 3 17 17 17 0 3 3 3 0 17 9
9 17 9 9 9 9 17 17 17 9 9 9 9 9 17 17 17 9 9 9 9 9 17 17 17 9 9 9 9 9 17 9
9 17 17 17 17 9 17 11 11 21 21 11 11 9 17 17 17 9 21 11 11 21 11 11 21 17 17 17 17 17 17 9
9 17 11 11 21 9 17 11 12 21 21 12 11 9 17 17 17 9 21 11 12 21 12 12 21 17 17 11 11 11 17 9
9 17 11 12 21 9 17 11 12 21 21 12 11 9 17 17 17 9 21 11 12 21 12 12 21 17 17 12 12 12 17 9
9 17 11 12 21 9 17 11 11 21 21 11 11 9 17 17 17 9 21 11 11 21 11 11 21 17 17 11 11 11 17 9
9 17 17 17 17 9 17 17 17 17 17 17 17 9 17 17 17 9 17 17 17 17 17 17 17 17 17 17 17 17 17 9
9 17 17 17 17 9 17 17 17 17 17 17 17 9 17 17 17 9 17 17 17 17 17 17 17 17 17 17 17 17 17 9
9 9 9 9 9 9 9 9 9 9 9 9 9 9 9 9 9 9 9 9 9 9 9 9 9 9 9 9 9 9 9 9
