7 7 7 7 7 7 17 17 7 7 7 7 7 9 7 7 7 7 7 7 7 9 7 7 7 7 7 7 7 7 7 7
7 8 8 8 8 8 17 17 17 17 17 17 17 17 17 17 17 17 17 17 17 17 17 17 17 17 17 17 17 17 17 17
7 15 17 17 17 8 17 17 17 17 17 17 17 17 17 17 17 17 17 17 17 17 17 17 17 17 17 17 17 17 17 17
7 8 17 17 17 8 17 17 7 7 27 7 7 7 12 7 7 7 7 7 7 7 7 7 7 7 17 7 7 7 17 17
27 8 17 17 17 8 17 17 12 7 7 7 7 7 12 12 7 7 7 12 9 9 27 7 8 8 15 8 8 7 17 17
7 8 17 17 17 15 17 17 12 12 7 9 9 12 12 12 12 12 12 12 12 12 7 7 8 17 17 17 8 7 17 17
7 8 17 17 17 15 17 17 12 12 12 12 12 12 12 12 12 12 12 12 12 12 7 7 8 17 17 17 8 7 17 17
7 8 8 8 8 8 17 17 12 12 12 12 12 7 7 7 12 12 7 12 12 7 7 7 8 8 8 8 8 7 17 17
7 17 17 17 17 17 17 17 12 12 12 7 7 7 7 7 7 12 12 12 12 9 7 7 7 7 7 7 7 7 17 17
7 17 17 17 17 17 17 17 12 12 7 7 7 8 8 8 8 7 7 12 12 12 7 7 9 9 7 9 9 7 17 17
9 17 17 9 7 7 7 12 12 12 9 7 7 15 17 32 8 7 7 9 12 12 7 7 7 7 7 7 7 7 17 17
7 17 17 7 7 7 7 12 12 12 9 7 7 8 17 17 8 7 7 17 17 17 7 9 7 7 27 7 7 27 17 17
7 17 17 7 27 7 12 12 12 12 9 7 7 8 17 17 8 7 7 17 17 17 7 9 7 7 7 7 7 7 17 17
7 17 17 7 7 7 7 12 12 12 7 7 7 8 15 15 8 7 7 9 12 12 7 9 7 7 7 7 7 7 17 17
7 17 17 9 7 7 7 7 12 12 12 12 7 7 17 17 7 7 7 12 12 7 7 7 7 7 7 7 7 7 17 17
7 17 17 9 7 7 7 7 12 12 12 12 7 7 17 17 7 7 12 12 12 12 7 7 9 9 7 9 9 7 17 17
7 17 17 7 7 7 7 9 9 12 12 12 7 9 17 17 9 12 12 12 12 12 7 7 7 7 7 7 7 7 17 17
7 17 17 7 7 9 7 7 9 9 12 12 12 12 17 17 12 12 12 12 12 12 12 7 7 7 7 7 7 7 17 17
7 17 17 7 7 9 7 7 7 9 7 9 9 7 17 17 9 7 7 7 12 12 7 27 8 8 8 8 8 7 17 17
7 17 17 27 7 9 7 7 7 7 7 27 7 7 17 17 9 7 7 27 9 7 7 7 8 17 17 17 8 7 17 17
7 17 17 7 7 9 9 9 9 27 7 7 7 9 17 17 7 7 7 7 9 7 7 7 8 17 17 17 8 7 17 17
7 17 17 7 7 7 7 7 9 7 7 7 7 7 17 17 7 7 7 7 9 7 7 7 8 8 15 8 8 7 17 17
9 17 17 9 7 7 7 7 7 7 7 7 7 9 17 17 9 7 7 7 9 7 7 7 7 7 17 7 7 9 17 17
7 17 17 17 17 17 17 17 17 17 17 17 17 17 17 17 17 17 17 17 17 17 17 17 17 17 17 17 17 17 17 17
9 17 17 17 17 17 17 17 17 17 17 17 17 17 17 17 17 17 17 17 17 17 17 17 17 17 17 17 17 17 17 17
9 7 7 9 7 7 7 7 7 17 17 7 7 9 7 9 7 7 17 17 7 8 8 8 8 8 8 8 8 15 8 7
7 7 8 8 8 8 8 8 8 15 15 8 7 7 7 7 8 8 15 15 8 8 17 17 17 17 8 17 17 17 8 7
7 7 8 17 17 17 8 17 17 17 17 8 7 7 9 7 8 17 17 17 17 8 17 17 17 17 15 17 17 17 8 7
7 9 8 17 17 17 15 17 17 17 17 8 7 7 9 7 8 17 17 17 17 15 17 17 17 17 15 17 17 17 8 7
7 7 15 17 17 17 8 17 17 17 17 8 7 7 7 7 8 17 17 17 17 8 17 17 17 17 8 17 17 17 8 7
7 7 15 15 8 8 8 8 8 8 8 8 9 9 7 7 8 15 8 8 8 8 8 8 8 8 8 8 8 15 8 7
7 7 7 7 7 7 7 7 7 7 7 7 7 7 7 7 9 7 7 7 7 7 7 7 7 7 7 7 7 7 7 7
