7 7 7 7 7 7 7 7 7 7 7 7 7 7 7 7 27 7 7 7 7 7 7 7 7 7 7 7 7 7 7 7
7 7 27 7 7 7 7 7 7 7 7 7 7 7 7 7 7 7 7 7 7 7 7 7 7 7 7 7 7 7 7 7
7 7 7 7 7 7 7 7 7 7 7 7 7 7 7 7 7 7 7 7 7 7 7 7 7 27 7 7 7 7 7 7
7 7 7 7 7 7 7 7 7 7 7 7 7 7 7 7 7 7 7 7 7 7 7 7 7 7 7 7 7 7 7 7
7 7 7 7 7 7 7 7 7 7 7 7 7 7 7 7 7 7 7 7 7 7 7 7 7 7 7 7 7 7 7 7
7 7 7 17 17 17 17 17 17 17 17 17 17 17 17 17 17 17 17 17 17 17 17 7 7 7 7 7 7 7 7 7
27 7 7 17 9 9 9 9 9 9 9 9 9 9 9 9 9 9 9 9 9 9 17 7 7 7 7 7 7 7 7 7
7 7 7 17 15 7 7 9 7 7 7 7 7 9 7 9 7 7 7 9 7 9 17 7 7 7 7 7 7 7 7 7
7 7 7 17 9 7 7 7 7 7 9 7 7 7 7 9 7 7 7 7 7 9 17 7 7 7 7 7 7 27 7 7
7 7 7 17 9 9 9 9 7 7 7 9 9 7 7 9 7 9 9 9 7 9 17 7 7 7 7 27 7 7 7 7
7 7 7 17 9 7 7 7 9 7 7 9 7 7 7 9 7 7 7 9 7 9 17 7 27 7 7 7 7 7 7 7
7 7 7 17 9 7 7 7 7 7 7 9 7 7 9 9 7 9 7 7 7 9 17 7 7 7 7 7 7 7 7 7
7 7 7 17 15 7 7 7 9 7 7 9 7 9 7 7 7 7 7 7 9 9 17 7 7 7 7 7 7 7 7 7
7 7 7 17 15 7 7 7 9 7 7 7 7 7 7 9 7 7 7 7 7 9 17 7 7 7 7 7 7 7 7 7
7 7 7 17 15 7 7 7 7 9 9 7 7 9 9 9 9 9 7 7 7 15 17 7 7 7 7 7 7 7 7 7
7 7 7 17 9 9 7 9 7 7 7 9 7 7 7 7 9 7 7 9 7 9 17 7 7 7 7 7 7 7 7 7
7 7 7 17 9 7 7 7 7 7 7 7 7 7 9 7 7 7 7 9 7 9 17 7 7 7 7 7 7 7 7 7
7 7 7 17 9 7 7 9 7 9 7 7 9 7 7 7 9 7 7 9 7 15 17 7 7 7 7 7 7 7 7 7
7 7 7 17 9 9 9 9 9 9 9 15 9 9 9 9 9 9 9 9 15 9 17 7 7 7 7 7 7 7 7 7
7 7 7 17 17 17 17 17 17 17 17 17 17 17 17 17 17 17 17 17 17 17 17 7 27 7 7 7 7 7 7 7
7 7 7 7 7 7 7 7 7 7 7 7 7 7 7 7 7 7 7 7 7 7 7 7 7 7 7 7 7 7 7 7
7 7 7 7 7 7 7 7 7 7 7 7 7 7 7 7 7 7 7 7 27 7 7 7 7 7 7 7 7 7 7 7
7 7 7 7 7 7 7 27 7 7 7 7 7 7 7 7 7 7 7 7 7 7 7 27 7 7 7 7 7 7 7 7
7 27 7 7 7 7 7 7 7 7 7 7 27 7 7 7 7 7 7 7 7 7 7 7 7 7 7 7 7 7 7 7
7 7 7 7 7 7 7 7 7 7 7 7 7 7 7 7 7 27 7 7 7 7 7 7 7 7 7 7 7 7 7 7
7 7 7 7 7 7 7 7 27 7 7 7 7 7 7 7 7 7 7 7 7 7 7 7 7 7 7 7 7 7 7 7
7 7 7 7 7 7 7 7 7 7 7 7 7 7 7 7 7 7 7 7 7 7 7 7 7 7 7 7 7 7 7 7
7 7 7 7 7 7 7 7 7 7 7 7 7 7 7 7 7 7 7 7 7 7 7 7 7 7 7 7 7 7 7 7
7 7 7 7 7 7 7 7 7 7 7 7 7 7 7 7 7 7 7 7 7 7 7 7 7 7 7 7 7 7 7 7
7 7 7 7 7 7 7 7 7 7 7 7 7 7 7 7 7 7 7 7 7 7 7 7 7 7 7 7 7 7 7 7
7 7 7 7 7 7 7 7 7 7 7 7 7 7 7 7 7 7 7 7 7 7 7 7 7 7 7 7 7 7 7 7
7 7 7 7 7 7 7 7 7 7 7 7 7 7 7 7 7 7 7 7 7 7 7 7 7 7 7 7 7 7 7 7
