9 9 9 9 9 9 9 9 9 9 9 9 9 9 9 9 9 9 9 9 9 9 9 9 9 9 9 9 9 9 9 9
9 9 21 21 21 21 21 9 21 21 21 21 9 21 21 21 9 9 21 21 21 21 21 21 21 21 21 21 21 21 21 9
9 21 21 9 9 21 21 21 21 21 21 9 21 21 21 21 9 9 9 9 21 9 21 21 8 8 8 8 8 8 8 9
9 21 21 9 21 21 21 9 9 21 21 21 21 21 21 21 21 21 9 9 9 9 21 21 8 17 17 17 17 17 8 9
9 21 21 21 21 21 9 9 21 21 21 8 8 8 8 8 21 21 21 21 9 9 21 21 8 17 17 17 17 17 8 9
9 21 21 21 9 9 9 21 21 21 21 8 17 17 17 8 21 21 21 21 21 9 21 21 8 17 17 17 17 17 8 9
9 21 21 9 9 21 21 21 21 21 21 8 17 17 17 8 21 9 21 21 21 21 21 9 8 8 8 15 15 8 8 9
9 9 9 9 21 21 14 14 9 21 21 8 8 15 8 8 21 21 21 9 21 21 21 21 21 21 21 14 14 21 21 9
9 9 21 21 21 21 14 14 21 21 21 21 17 17 17 21 21 21 21 21 9 9 21 21 21 21 21 14 14 9 21 9
9 21 21 21 21 21 21 21 9 9 9 21 17 17 10 21 9 21 21 21 21 9 9 21 21 21 21 14 14 9 21 9
9 21 21 21 21 9 9 21 9 10 10 21 9 9 10 21 9 21 21 21 21 21 21 9 21 21 14 14 14 21 21 9
9 21 21 9 9 9 9 9 10 10 10 10 21 21 10 10 21 21 21 10 21 21 21 9 9 8 15 15 8 8 9 9
9 21 21 9 14 14 14 21 21 21 10 10 10 10 10 10 10 10 10 10 10 10 21 21 21 8 17 17 17 8 21 9
9 21 21 9 14 14 14 21 21 21 10 10 10 10 10 10 10 10 14 14 14 14 9 9 14 8 17 17 17 8 21 9
9 21 21 21 21 21 21 21 21 21 21 10 10 10 10 10 10 10 14 14 9 14 14 14 14 8 17 17 17 8 21 9
9 9 9 9 9 9 9 9 9 9 14 10 10 10 10 10 10 10 14 9 9 9 14 14 9 8 17 17 17 8 21 9
9 21 21 9 9 8 8 8 8 9 17 10 10 10 10 10 10 10 14 14 14 14 14 14 14 8 17 17 17 8 21 9
9 21 21 9 9 8 17 17 8 9 17 17 17 10 21 21 10 10 10 10 10 21 21 21 21 8 8 15 8 8 21 9
9 21 21 21 9 8 17 17 8 9 17 17 17 14 21 21 21 10 10 10 9 21 21 21 9 21 14 14 14 21 21 9
9 21 21 21 9 8 17 17 8 9 17 17 9 14 21 21 21 9 21 21 21 21 21 9 21 21 14 14 14 21 21 9
9 21 21 21 9 8 17 17 16 16 17 17 9 14 21 21 21 21 21 21 21 21 21 9 21 21 14 14 14 21 9 9
9 21 9 21 9 8 8 8 8 9 14 14 14 14 9 9 9 9 9 14 14 14 14 14 9 14 14 14 14 9 14 9
9 21 21 21 9 9 9 9 9 9 21 21 21 21 21 21 21 21 21 14 14 17 17 17 17 17 17 9 9 17 17 9
9 21 9 21 21 21 21 21 21 21 21 21 21 21 21 9 21 21 21 9 14 17 27 2 2 2 2 2 2 27 2 9
9 21 9 21 21 9 9 9 9 9 9 9 9 21 21 9 21 21 21 14 14 17 2 3 3 3 3 3 3 3 3 9
9 21 21 21 21 21 21 21 9 14 14 14 14 21 21 9 21 21 21 14 14 17 2 3 4 4 4 4 4 4 4 9
9 21 21 9 21 21 21 21 17 17 17 17 9 21 9 9 9 9 21 9 9 9 2 3 4 5 5 5 5 5 5 9
9 21 21 21 21 9 21 9 17 17 17 17 9 21 21 9 21 21 14 14 14 17 2 3 4 5 6 6 6 6 6 9
9 21 21 21 21 21 21 9 14 14 14 14 9 21 9 9 21 21 14 14 14 17 27 3 4 5 6 7 7 7 7 9
9 21 21 9 21 21 21 9 21 21 21 21 9 21 21 9 21 9 14 14 14 17 2 3 4 5 6 7 7 7 7 9
9 21 21 21 21 21 21 9 21 21 21 21 9 21 21 21 21 21 14 14 14 17 2 3 4 5 6 7 7 7 7 9
9 9 9 9 9 9 9 9 9 9 9 9 9 9 9 9 9 9 9 9 9 9 9 9 9 9 9 9 9 9 9 9
