8 8 8 8 8 8 8 10 10 10 8 8 8 8 0 9 9 9 9 6 0 3 3 0 8 8 8 8 8 8 8 8
8 8 8 8 8 20 20 20 10 10 10 20 8 8 8 9 16 16 15 6 5 5 5 5 4 0 8 8 8 8 8 8
8 8 8 8 8 20 20 20 20 10 10 10 20 8 8 9 9 9 9 5 0 5 6 0 4 4 0 0 8 8 8 8
8 8 8 8 8 20 20 20 20 20 10 10 10 8 8 8 8 0 0 0 0 0 7 5 5 4 0 0 8 8 8 8
8 8 0 0 8 8 20 20 20 20 20 10 10 14 20 20 8 8 8 8 0 0 0 7 7 5 3 0 0 8 8 8
8 8 0 0 0 8 8 8 20 20 20 10 14 14 14 20 20 20 20 8 8 8 14 6 6 5 5 3 0 0 8 8
8 9 9 9 0 0 0 8 8 20 20 14 14 14 10 20 20 20 20 20 8 14 14 14 4 5 5 0 3 0 8 8
8 9 16 9 0 0 0 0 8 20 20 20 14 10 10 20 20 20 20 20 14 14 14 8 4 0 5 4 4 3 0 0
0 9 16 9 0 0 0 0 8 20 20 20 20 10 10 10 20 20 20 20 20 14 20 8 0 0 5 0 0 4 3 0
0 9 15 9 3 0 0 0 8 20 20 20 20 10 10 10 20 20 20 20 20 20 20 8 8 4 0 4 5 0 0 0
0 5 7 4 3 0 0 0 8 20 20 20 20 20 10 10 10 20 20 20 20 20 20 20 8 0 4 5 6 0 4 3
0 4 6 4 4 3 0 0 8 8 20 20 20 20 10 10 10 20 20 20 20 20 20 20 8 0 0 5 5 5 0 0
0 4 7 5 4 0 0 0 8 8 20 20 20 20 20 10 10 10 20 20 20 20 20 20 8 0 0 3 5 6 3 0
0 3 0 5 5 4 3 0 0 8 20 20 20 20 20 10 10 10 20 20 20 20 20 20 8 8 0 0 5 5 4 0
0 0 4 5 6 5 0 0 8 8 20 20 20 20 20 20 10 10 10 20 20 20 20 20 20 8 0 0 4 5 5 0
0 0 0 0 6 5 0 0 8 8 20 20 20 20 20 20 10 10 10 14 20 20 20 20 8 8 3 0 5 5 4 3
0 3 0 4 5 5 5 5 8 8 8 14 20 20 20 20 20 10 14 14 14 20 20 20 8 0 0 0 4 5 4 0
0 0 0 3 0 0 4 0 0 8 14 14 14 20 20 20 20 14 14 14 10 20 20 20 8 0 0 3 5 5 0 3
0 0 0 0 0 4 5 4 5 14 14 14 20 20 20 20 20 20 14 10 10 20 20 8 8 0 0 4 0 5 4 0
0 0 0 0 0 4 4 5 6 4 14 8 8 8 20 20 20 20 20 10 10 10 8 8 0 0 3 4 6 7 4 3
0 0 0 0 0 3 0 0 5 4 0 0 8 8 8 8 20 20 8 10 10 10 10 0 0 0 4 0 5 7 3 0
8 0 0 0 0 0 0 0 5 5 0 3 3 0 8 8 8 8 8 10 10 10 10 0 0 3 0 5 5 0 3 0
8 8 0 0 0 0 0 4 4 5 6 6 0 3 0 0 0 8 0 0 10 10 10 10 0 3 5 7 4 3 3 0
8 8 0 0 0 0 0 3 0 5 5 4 4 3 0 0 0 0 0 0 0 10 10 10 0 0 5 5 3 0 0 0
8 8 8 0 0 0 0 0 0 4 5 5 0 4 3 3 0 0 0 0 0 10 10 10 10 14 6 5 0 0 0 0
8 8 8 0 0 0 0 0 0 0 0 6 5 5 0 0 0 0 3 0 0 0 10 10 14 14 14 0 0 0 0 0
8 8 8 8 0 0 0 0 3 0 4 0 5 6 6 4 0 3 0 3 0 3 10 14 14 14 10 0 0 0 0 0
8 8 8 8 0 0 0 0 0 0 0 0 4 4 5 6 0 0 0 4 4 4 14 14 14 10 10 10 0 0 0 0
8 8 8 8 8 8 0 0 0 0 0 3 0 0 5 6 6 5 0 4 0 5 7 14 10 10 10 10 0 0 0 0
8 8 8 8 8 8 8 0 0 0 0 0 0 0 0 4 5 5 5 5 6 6 7 0 0 10 10 10 10 0 0 0
8 8 8 8 8 8 8 8 8 8 0 0 0 0 3 0 4 0 4 0 5 0 0 0 0 10 10 10 10 10 0 0
8 8 8 8 8 8 8 8 8 8 8 0 0 0 0 3 0 3 0 4 0 0 0 0 0 0 10 10 10 10 0 0
