9 9 9 9 9 9 9 9 9 9 9 9 9 9 9 9 9 9 9 9 9 9 9 9 9 9 9 9 9 9 9 9
9 17 17 17 17 9 9 4 5 5 9 17 17 17 9 9 9 17 17 17 9 4 5 5 9 17 17 17 17 17 17 9
9 11 11 11 17 9 4 4 6 6 9 11 11 17 9 4 5 11 11 17 9 6 6 4 9 11 11 11 21 21 17 9
9 11 12 11 17 9 6 7 7 6 9 12 12 17 9 6 7 12 12 17 9 7 7 6 9 12 12 11 21 21 17 9
9 11 12 12 17 0 6 6 6 6 0 12 12 17 0 6 6 12 12 17 0 6 6 6 0 12 12 11 21 21 17 9
9 11 11 11 17 0 5 5 5 5 0 11 11 17 0 5 5 11 11 17 0 5 5 5 0 11 11 11 21 21 17 9
9 17 17 17 17 0 4 3 3 4 0 17 17 17 0 4 4 17 17 17 0 3 3 4 0 17 17 17 17 17 17 9
9 9 9 9 17 9 4 9 9 4 9 9 9 17 9 4 9 9 9 17 9 4 9 9 9 17 9 9 9 9 9 9
9 17 17 0 17 0 4 4 3 4 0 17 17 17 0 4 4 4 4 17 0 4 4 3 0 17 0 17 17 17 17 9
9 17 11 0 17 0 5 5 5 5 0 11 11 17 0 5 5 5 5 17 0 5 5 5 0 12 0 11 11 11 17 9
9 17 12 0 17 0 6 7 7 6 0 12 12 17 0 7 7 6 6 17 0 6 7 7 0 12 0 12 12 12 17 9
9 17 12 0 17 0 6 6 6 6 0 12 12 17 0 6 6 6 6 17 0 6 6 6 0 12 0 12 12 12 17 9
9 17 11 0 17 0 5 5 5 5 0 11 11 17 0 5 5 5 5 17 0 5 5 5 0 11 0 11 11 11 17 9
9 17 17 0 17 0 4 4 4 4 0 17 17 17 0 4 4 4 4 17 0 4 4 4 0 17 0 17 17 17 17 9
9 9 9 0 9 9 9 4 9 9 9 9 9 9 9 9 9 9 4 9 9 9 9 9 9 9 9 9 9 9 17 9
9 17 17 0 17 17 17 4 0 17 17 17 17 17 17 17 17 17 4 0 17 17 17 17 17 17 17 17 17 9 17 9
9 11 11 0 11 11 17 4 0 11 11 11 21 21 21 11 11 11 4 0 21 21 21 11 11 11 11 21 21 9 17 9
9 12 12 0 12 12 17 4 0 12 12 12 21 21 21 12 12 12 4 0 21 21 21 12 12 12 12 21 21 9 17 9
9 12 12 0 12 12 17 4 0 12 12 12 21 21 21 12 12 12 4 0 21 21 21 12 12 12 12 21 21 9 17 9
9 11 11 0 11 11 17 4 0 11 11 11 21 21 21 11 11 11 4 0 21 21 21 11 11 11 11 21 21 9 17 9
9 17 17 0 17 17 17 4 0 17 17 17 17 17 17 17 17 17 4 0 17 17 17 17 17 17 17 17 17 9 17 9
9 9 9 9 9 9 17 4 9 9 9 9 9 9 9 9 9 9 4 9 9 9 9 9 9 9 9 9 17 9 9 9
9 17 17 17 17 17 17 4 0 17 17 17 17 17 17 17 17 17 4 0 17 17 17 17 17 17 17 17 17 9 17 9
9 11 11 11 11 21 21 4 0 11 11 11 11 21 21 21 11 11 4 0 21 21 21 11 11 11 11 21 21 9 17 9
9 12 12 12 12 21 21 4 0 12 12 12 12 21 21 21 12 12 4 0 21 21 21 12 12 12 12 21 21 9 17 9
9 12 12 12 12 21 21 4 0 12 12 12 12 21 21 21 12 12 4 0 21 21 21 12 12 12 12 21 21 9 17 9
9 11 11 11 11 21 21 4 0 11 11 11 11 21 21 21 11 11 4 0 21 21 21 11 11 11 11 21 21 9 17 9
9 17 17 17 17 17 17 17 0 17 17 17 17 17 17 17 17 17 0 17 17 17 17 17 17 17 17 17 17 17 17 9
9 9 9 9 9 9 9 9 9 9 9 9 9 9 9 9 9 9 9 9 9 9 9 9 9 9 9 9 9 9 9 9
