2 2 0 27 2 0 9 0 9 0 0 0 0 27 0 0 0 27 27 0 0 0 0 0 0 0 27 0 0 27 0 0
2 2 0 0 27 0 0 0 0 0 0 27 0 0 0 0 0 0 0 0 9 9 9 0 27 0 0 0 0 0 0 0
2 0 0 0 0 27 0 27 0 0 0 0 0 0 0 0 0 0 0 0 0 9 9 0 9 0 0 0 0 27 0 0
0 27 2 0 0 0 0 0 0 9 9 8 8 8 8 0 0 0 9 0 0 0 0 0 0 0 0 0 0 0 0 0
2 2 27 0 27 0 0 0 0 8 17 17 17 17 8 0 0 0 9 0 0 0 0 0 9 0 0 0 9 0 0 0
2 0 0 0 0 0 0 27 0 8 17 17 17 17 15 0 0 0 9 0 0 9 0 27 9 0 0 0 0 27 27 0
2 2 2 9 0 0 9 0 0 8 17 17 17 17 15 0 0 0 9 0 0 0 0 0 9 0 0 0 0 0 0 0
0 2 0 9 0 0 0 0 0 8 17 17 17 17 8 0 0 0 2 2 2 0 2 0 9 9 9 9 9 2 27 0
2 0 9 9 0 0 0 9 0 8 8 8 8 8 8 0 0 0 3 3 3 3 3 3 3 3 3 3 3 3 2 0
2 0 2 9 0 0 0 9 0 0 0 0 0 0 0 0 9 0 3 27 4 4 4 4 4 4 4 4 4 27 2 0
0 2 2 0 0 0 0 0 0 9 0 0 0 27 0 0 9 0 3 4 5 5 5 5 5 5 5 5 4 3 2 0
0 0 0 0 0 0 0 9 0 0 0 0 0 0 0 0 9 0 3 4 5 6 6 6 6 6 6 5 4 3 2 0
0 0 0 0 0 0 0 0 0 0 9 9 0 0 0 0 9 0 3 4 5 6 7 7 7 7 6 5 4 3 2 0
0 9 9 9 0 0 0 9 0 0 0 9 9 0 0 0 0 9 3 4 5 6 7 7 7 7 6 5 4 3 9 0
0 0 9 0 0 0 0 0 0 0 0 0 9 9 0 0 0 2 3 4 5 6 6 6 7 7 6 5 4 3 2 0
0 0 9 9 0 0 0 27 0 0 0 0 0 9 9 0 0 2 3 4 5 5 5 6 6 6 6 5 4 3 2 0
0 0 0 0 27 0 0 0 0 0 0 0 0 0 9 9 0 0 3 4 4 4 5 5 5 5 9 5 4 3 27 0
0 0 0 0 2 0 0 0 9 27 9 0 0 0 9 0 9 0 9 3 3 4 4 4 4 4 4 4 4 3 2 0
0 0 9 2 0 0 27 0 0 0 0 0 0 0 0 0 0 0 9 2 3 3 3 3 3 3 3 3 3 3 2 0
2 2 2 0 0 2 0 0 0 0 0 0 0 0 0 0 3 3 3 3 3 3 9 3 3 3 8 8 8 8 8 8
8 8 8 8 8 8 0 0 0 0 9 9 9 0 0 0 3 4 4 4 4 4 9 4 4 4 8 17 17 17 17 8
8 17 17 17 17 8 0 0 0 0 0 27 0 0 0 27 3 4 5 5 5 5 5 5 4 4 15 17 17 17 17 8
8 17 17 17 17 16 0 0 0 9 0 0 0 0 0 0 3 4 5 5 6 6 6 5 5 5 8 17 17 17 17 8
8 17 17 17 17 16 2 0 9 9 0 0 0 0 0 0 3 9 9 5 6 7 6 6 6 5 8 8 8 8 8 8
8 17 17 17 17 8 0 0 9 9 0 0 0 0 0 0 3 9 9 5 6 6 7 7 9 9 9 9 9 0 0 0
8 8 8 8 8 8 0 0 9 9 0 27 0 0 0 0 3 9 9 5 5 6 7 7 6 5 4 3 9 0 0 0
0 0 0 2 9 2 0 0 0 0 0 0 9 9 0 0 9 9 4 4 5 6 9 6 6 9 4 3 9 0 0 0
2 2 0 2 9 0 0 0 0 0 0 9 9 0 0 0 3 3 3 4 4 4 9 5 5 4 3 3 9 0 9 0
0 0 27 2 9 0 0 27 0 0 0 0 9 9 9 0 0 0 3 3 4 4 9 4 4 4 3 0 0 0 0 0
0 2 0 0 9 0 0 0 9 0 0 0 0 0 0 0 0 0 0 0 3 3 9 3 3 9 0 0 0 0 0 0
2 2 0 0 27 0 0 0 9 0 0 0 0 27 0 0 0 0 0 0 0 0 0 0 0 0 0 0 9 0 0 0
0 0 0 0 0 0 0 0 9 0 0 0 0 0 0 0 9 9 9 0 0 0 0 0 0 0 0 0 0 0 0 0
