0 0 0 0 0 0 0 0 8 8 8 8 8 8 8 8 8 8 8 8 8 8 8 8 8 8 8 0 0 0 0 0
0 0 0 0 0 4 5 4 15 17 17 17 17 17 17 17 17 9 17 17 17 17 17 17 17 17 15 4 4 5 7 0
0 0 0 4 4 0 5 5 15 17 17 17 17 17 17 17 17 9 17 17 17 17 17 17 17 17 15 0 0 0 4 0
0 0 0 5 4 5 0 0 8 17 17 17 17 17 17 17 17 17 17 17 17 17 17 17 17 17 8 0 0 4 4 0
0 0 4 0 7 0 0 0 8 17 17 17 17 17 17 17 17 17 17 17 17 17 17 17 17 17 8 0 0 6 5 0
0 0 4 4 4 0 0 0 8 17 17 17 17 17 17 17 17 17 17 17 17 17 17 17 17 17 8 0 0 5 0 0
0 4 4 7 0 0 0 0 8 17 17 17 17 17 17 17 17 17 17 17 17 17 17 17 17 17 8 0 0 7 4 0
0 0 0 0 0 0 0 0 8 17 17 17 17 17 17 17 17 17 17 17 17 17 17 17 17 17 8 0 0 6 5 0
0 5 4 4 0 0 0 0 8 17 17 17 17 17 17 17 17 9 17 17 17 17 17 17 17 17 8 0 0 0 4 0
0 0 4 0 0 0 0 0 8 17 17 17 17 17 17 17 17 9 17 17 17 17 17 17 17 17 8 0 0 7 0 0
0 0 0 4 0 0 0 0 8 17 17 17 17 17 17 17 17 9 17 17 17 17 17 17 17 17 8 0 0 0 5 0
0 0 5 0 0 0 0 0 8 8 8 15 15 15 8 8 8 8 8 8 8 8 8 8 8 8 8 0 0 0 4 0
0 0 0 4 2 0 2 2 0 0 3 2 6 4 0 0 2 2 0 2 0 0 0 0 0 0 2 0 2 0 0 3
2 3 4 3 5 3 3 0 3 2 3 4 6 4 3 3 0 3 2 4 0 2 0 2 2 3 3 0 3 3 6 5
6 6 5 6 5 4 0 5 4 4 6 0 6 4 7 4 0 6 0 5 5 6 2 5 4 5 6 5 5 4 4 4
4 6 5 6 7 7 6 4 4 4 6 4 2 2 2 4 2 2 4 6 7 4 5 6 4 5 4 5 0 5 3 4
4 4 3 4 3 5 4 3 3 0 2 0 0 0 0 0 0 0 0 3 5 6 6 4 3 3 0 3 0 7 2 3
0 2 2 3 2 0 2 2 0 0 0 0 0 0 0 2 0 2 2 0 3 6 5 2 0 0 2 0 0 3 3 0
0 0 2 3 0 0 0 0 8 8 8 8 8 8 8 8 8 8 8 8 8 15 15 15 8 8 8 0 0 2 0 0
0 0 2 3 0 0 0 0 8 17 17 17 17 17 17 17 17 9 17 17 17 17 17 17 17 17 8 0 0 7 2 0
2 0 3 5 3 0 0 0 8 17 17 17 17 17 17 17 17 9 17 17 17 17 17 17 17 17 8 0 0 3 3 0
0 0 4 4 3 0 0 0 8 17 17 17 17 17 17 17 17 9 17 17 17 17 17 17 17 17 8 0 0 2 2 0
0 0 3 2 0 0 0 0 8 17 17 17 17 17 17 17 17 17 17 17 17 17 17 17 17 17 8 0 0 3 0 3
2 0 0 5 4 0 0 0 8 17 17 17 17 17 17 17 17 17 17 17 17 17 17 17 17 17 8 0 0 0 2 0
0 0 0 0 2 0 0 0 8 17 17 17 17 17 17 17 17 17 17 17 17 17 17 17 17 17 8 0 0 2 3 3
0 0 2 3 3 7 0 0 8 17 17 17 17 17 17 17 17 17 17 17 17 17 17 17 17 17 8 0 2 3 2 2
0 0 2 4 0 3 0 0 8 17 17 17 17 17 17 17 17 17 17 17 17 17 17 17 17 17 8 0 0 0 3 0
0 0 0 3 6 0 2 6 15 17 17 17 17 17 17 17 17 9 17 17 17 17 17 17 17 17 15 2 2 2 2 0
0 0 0 0 3 5 5 0 15 17 17 17 17 17 17 17 17 9 17 17 17 17 17 17 17 17 15 4 5 3 0 2
0 0 0 0 0 3 0 3 8 8 8 8 8 8 8 8 8 8 8 8 8 8 8 8 8 8 8 0 0 0 0 0
0 0 0 0 0 0 0 0 0 0 0 0 0 0 0 0 0 0 0 0 0 0 0 0 0 0 0 0 0 0 0 0
0 0 0 0 0 0 0 0 0 0 0 0 0 0 0 0 0 0 0 0 0 0 0 0 0 0 0 0 0 0 0 0
