0 0 0 21 21 10 10 10 10 21 21 0 0 18 18 18 18 18 0 0 0 0 0 0 0 0 0 0 0 0 0 0
0 0 0 21 21 10 10 10 10 21 21 21 0 18 17 17 17 18 0 0 0 21 21 21 21 21 21 21 21 21 21 0
0 0 0 21 17 17 17 17 17 17 17 21 0 15 17 17 17 15 0 0 21 21 21 21 21 21 21 21 21 21 21 21
0 0 0 0 17 17 17 17 17 17 17 21 21 18 17 17 17 18 21 21 21 21 21 10 10 10 10 10 10 21 21 21
0 0 0 0 21 21 10 10 10 10 10 21 21 18 18 18 18 18 21 21 21 21 10 10 10 10 10 10 10 10 10 21
0 0 0 0 0 21 21 10 10 10 10 21 21 21 21 21 21 21 10 10 10 10 10 10 10 10 10 10 10 10 10 10
0 0 0 0 0 21 21 10 10 10 10 10 10 10 10 10 10 10 10 10 10 10 10 10 10 10 10 10 10 10 10 10
0 0 0 0 0 0 21 21 10 10 10 10 10 10 10 10 10 10 10 10 10 10 10 21 21 21 21 21 10 10 10 10
0 0 0 0 0 0 21 21 21 10 10 10 10 10 10 10 10 10 10 10 10 21 21 21 21 21 21 21 21 10 10 10
0 21 21 21 21 21 21 21 21 21 21 21 21 21 21 21 21 21 21 21 21 21 21 21 21 21 21 21 21 10 10 10
21 21 21 21 21 21 21 21 21 0 21 0 21 21 0 21 0 0 21 21 0 0 0 0 21 21 21 21 10 10 10 21
21 21 10 10 10 10 10 21 21 21 21 0 0 0 0 0 0 0 0 0 0 0 0 0 21 21 21 21 10 10 10 21
21 10 10 10 10 10 10 10 21 21 21 21 21 0 0 0 21 0 0 0 21 0 21 0 21 21 21 10 10 10 21 21
21 10 10 10 10 10 10 10 10 21 21 21 21 21 21 21 21 21 21 21 21 21 21 21 21 21 10 10 10 21 21 21
10 10 10 10 21 21 21 10 10 10 10 10 21 21 21 17 17 21 21 21 21 21 21 21 10 10 10 10 10 21 21 21
10 10 10 21 21 21 21 21 10 10 10 10 10 10 10 17 17 10 10 10 10 10 10 10 10 10 10 21 21 21 21 0
10 10 10 21 21 21 21 21 21 10 10 10 10 10 10 17 17 10 10 10 10 10 10 10 10 21 21 21 21 21 0 0
10 10 10 21 21 21 21 21 21 21 21 10 10 10 10 17 17 10 10 10 10 10 10 10 10 21 21 21 0 0 0 0
21 10 10 10 21 21 21 21 21 21 21 21 21 21 21 17 17 21 21 21 21 21 21 21 21 21 20 20 20 20 20 0
21 10 10 10 10 21 21 21 21 21 21 21 21 21 21 21 21 21 0 21 21 21 21 21 21 0 20 17 17 17 20 0
21 21 10 10 10 10 21 21 21 21 21 21 21 21 21 0 0 0 21 21 0 0 0 0 0 0 20 17 17 17 20 0
21 21 21 10 10 10 10 21 21 21 21 21 21 21 0 21 21 0 0 0 0 21 0 0 0 0 20 17 17 17 20 0
0 21 21 21 10 10 10 10 21 21 17 17 21 21 21 21 21 21 21 21 21 21 21 0 21 0 20 20 15 20 20 0
0 0 21 21 21 10 10 10 10 10 17 17 10 10 10 10 10 10 21 21 21 21 21 21 21 21 0 0 0 0 0 0
0 0 21 21 21 10 10 10 10 10 17 17 10 10 10 10 10 10 10 10 10 10 10 10 10 21 21 0 0 0 0 0
0 0 0 0 21 21 21 10 10 10 17 17 10 10 10 10 10 10 10 10 10 10 10 10 10 10 21 21 21 21 0 0
0 0 0 0 0 0 21 21 21 21 17 17 21 21 21 21 21 21 21 21 21 10 10 10 10 10 10 10 21 21 0 0
0 0 0 0 0 0 21 21 21 21 21 21 21 21 21 21 21 21 21 21 21 21 21 10 10 10 10 10 10 21 21 0
0 0 0 0 0 0 0 0 0 0 21 0 21 0 0 0 0 21 21 21 21 21 10 10 10 10 10 10 10 21 21 0
0 0 0 0 0 0 0 0 0 0 0 0 0 0 0 0 0 0 21 21 10 10 10 10 10 10 10 21 21 21 0 0
0 0 0 0 0 0 0 0 0 0 0 0 0 0 0 0 21 21 21 10 10 10 10 10 10 10 21 21 21 0 0 0
0 0 0 0 0 0 0 0 0 0 0 0 0 0 0 21 21 10 10 10 10 10 10 10 21 21 21 21 0 0 0 0
