0 0 0 0 0 0 0 3 3 3 3 5 5 5 8 8 8 8 8 5 5 5 5 3 3 5 0 0 0 0 0 0
0 0 0 0 0 0 3 4 4 5 4 4 4 4 16 17 17 17 16 7 7 7 0 6 6 3 3 3 0 0 0 0
0 0 0 0 0 3 4 4 5 4 4 0 0 0 16 17 17 17 16 4 4 4 4 4 4 4 6 3 3 0 0 0
0 0 0 0 3 4 5 4 4 0 0 0 0 0 8 17 17 17 8 0 0 0 0 0 0 4 4 6 5 3 0 0
0 0 0 3 5 5 4 4 0 0 0 0 0 0 8 8 8 8 8 0 0 0 0 0 0 0 4 4 6 3 3 0
0 0 3 3 6 0 4 0 0 9 9 9 0 0 0 0 0 0 0 0 0 9 9 9 0 0 0 4 7 5 3 3
0 3 3 6 7 4 0 0 0 9 9 9 0 0 0 0 0 0 0 0 0 9 9 9 0 0 0 4 0 5 0 3
0 3 6 7 4 0 0 0 0 9 9 9 0 0 0 0 0 0 0 0 0 9 9 9 0 0 0 0 4 5 6 3
4 3 6 0 4 0 0 0 0 0 0 0 9 9 9 0 0 0 9 9 9 0 0 0 0 0 0 0 4 5 5 3
3 0 6 4 4 0 0 0 0 0 0 0 9 9 9 0 0 0 9 9 9 0 0 0 0 0 0 0 4 0 5 3
0 6 4 4 0 0 0 0 0 0 0 0 9 9 9 0 0 0 9 9 9 0 0 0 0 0 0 0 3 0 5 3
3 4 6 4 0 0 9 9 9 0 0 0 0 0 0 9 9 9 0 0 0 0 0 0 9 9 9 0 3 4 5 3
3 4 6 4 0 0 9 9 9 0 0 0 0 0 0 9 9 9 0 0 0 0 0 0 9 9 9 0 3 4 0 3
0 4 4 0 0 0 9 9 9 0 0 0 0 0 0 9 9 9 0 0 0 0 0 0 9 9 9 0 3 4 0 3
4 6 6 0 0 0 0 0 0 9 9 9 0 0 0 9 9 9 0 0 0 9 9 9 0 0 0 0 3 4 7 3
4 4 0 0 0 0 0 0 0 9 9 9 0 0 0 9 9 9 0 0 0 9 9 9 0 0 0 0 3 4 7 0
4 4 0 0 0 0 0 0 0 9 9 9 0 0 0 9 9 9 0 0 0 9 9 9 0 0 0 0 3 4 7 0
5 4 0 0 0 0 9 9 9 0 0 0 0 0 0 9 9 9 0 0 0 0 0 0 9 9 9 0 3 4 7 0
5 4 4 0 0 0 9 9 9 0 0 0 0 0 0 9 9 9 0 0 0 0 0 0 9 9 9 0 3 4 7 5
5 4 0 0 0 0 9 9 9 0 0 0 0 0 0 9 9 9 0 0 0 0 0 0 9 9 9 0 3 4 7 5
6 4 0 4 0 0 0 0 0 0 0 0 9 9 9 0 0 0 9 9 9 0 0 0 0 0 0 0 3 6 7 6
3 4 4 0 0 0 0 0 0 0 0 0 9 9 9 0 0 0 9 9 9 0 0 0 0 0 0 3 4 0 7 0
3 5 4 0 4 0 0 0 0 0 0 0 9 9 9 0 0 0 9 9 9 0 0 0 0 0 0 3 4 0 6 5
3 0 4 4 4 0 0 0 0 9 9 9 0 0 0 0 0 0 0 0 0 9 9 9 0 0 0 3 4 0 5 5
3 7 5 4 4 4 0 0 0 9 9 9 0 0 0 0 0 0 0 0 0 9 9 9 0 0 3 3 6 5 5 7
3 3 7 0 4 4 0 0 0 9 9 9 0 0 0 0 0 0 0 0 0 9 9 9 3 3 3 4 5 0 7 3
0 3 3 0 5 4 4 0 0 0 0 0 0 0 0 0 0 0 0 0 0 0 0 3 3 5 4 6 0 3 3 0
0 0 3 3 7 4 7 4 4 0 0 0 0 8 8 8 8 8 8 8 0 0 0 4 4 4 6 6 3 3 0 0
0 0 0 3 3 5 4 5 5 4 4 4 4 16 17 17 17 17 17 16 4 4 4 7 6 6 0 3 3 0 0 0
0 0 0 0 0 3 3 6 7 5 5 5 5 16 17 17 17 17 17 16 5 0 6 6 6 0 3 3 0 0 0 0
0 0 0 0 0 0 0 0 6 6 6 6 6 16 17 17 17 17 17 16 6 6 6 0 3 3 0 0 0 0 0 0
0 0 0 0 0 0 0 0 0 0 0 0 6 8 8 8 8 8 8 8 3 3 3 3 0 0 0 0 0 0 0 0
