9 9 9 9 9 9 9 9 9 9 9 9 9 9 9 9 9 9 9 9 9 9 9 9 9 9 9 9 9 9 9 9
9 21 21 21 10 10 10 10 21 21 21 21 21 9 0 0 0 0 0 0 0 27 0 0 0 0 0 27 0 0 0 9
9 21 21 17 17 17 17 17 17 17 21 21 21 9 0 27 0 0 0 0 0 0 0 9 0 0 0 0 0 0 0 9
9 21 21 21 10 10 10 10 21 21 21 21 21 9 0 0 9 9 9 9 9 0 0 0 0 0 9 0 0 0 0 9
9 21 21 21 10 10 10 10 10 10 21 21 21 9 0 0 0 0 0 0 9 0 0 0 0 0 9 0 9 9 9 9
9 9 9 21 21 10 10 10 10 10 10 21 21 21 0 9 0 0 0 0 9 0 0 0 0 0 9 0 0 0 0 9
9 0 0 21 21 21 21 10 10 10 10 21 21 21 21 0 0 0 0 0 9 9 27 0 9 9 9 9 0 0 0 9
9 0 0 0 0 21 21 21 10 10 10 10 21 21 21 9 9 0 0 0 0 0 0 0 27 0 9 9 0 0 0 9
9 0 9 9 0 0 21 21 21 10 10 10 10 21 21 21 21 0 0 0 0 0 0 0 0 0 0 0 0 27 0 9
9 0 0 0 0 27 0 21 21 21 10 10 10 10 21 21 21 21 21 21 0 9 0 0 0 0 9 0 0 0 0 9
9 0 27 0 0 0 0 0 21 21 21 10 10 10 21 21 21 21 21 21 21 21 21 0 0 0 0 0 0 0 0 9
9 0 0 0 9 0 0 9 9 9 21 21 10 10 9 21 21 9 21 21 9 21 21 0 0 9 0 9 9 9 9 9
9 0 0 0 9 0 27 0 0 0 21 21 10 10 10 21 21 21 17 17 21 21 21 0 0 9 0 0 0 0 0 9
9 27 0 0 9 0 0 0 0 0 21 21 10 10 10 10 10 21 17 17 10 21 21 21 21 9 0 0 0 0 0 9
9 0 0 0 9 0 27 0 0 0 21 21 10 10 12 12 10 10 17 17 10 10 10 10 21 21 21 0 0 0 0 9
9 0 0 0 0 0 0 0 0 21 21 21 10 10 12 12 10 10 17 17 10 10 10 10 21 9 9 9 9 9 9 9
9 0 0 0 0 0 0 0 0 0 21 21 10 10 12 12 12 10 21 21 10 12 10 21 21 21 21 21 21 9 9 9
9 9 9 9 9 0 0 9 9 9 21 10 10 10 10 12 12 10 21 21 10 12 10 10 21 21 21 21 21 21 0 9
9 3 3 3 0 0 0 0 0 0 21 21 21 10 10 10 10 10 17 17 10 12 12 10 21 21 21 21 21 21 0 9
9 3 3 3 0 3 3 3 3 21 21 21 21 21 10 10 10 10 17 17 10 12 12 10 10 10 21 21 21 21 21 9
9 3 4 4 4 4 4 4 4 4 3 21 21 21 21 10 21 10 17 17 10 12 10 10 10 21 21 21 21 21 21 9
9 3 4 5 5 5 5 5 5 4 3 2 21 21 21 21 21 21 17 17 10 10 10 10 10 21 21 21 21 21 21 9
9 3 4 5 6 6 6 6 5 4 3 2 0 21 21 21 21 21 17 17 10 10 10 10 21 21 21 21 9 9 21 9
9 3 4 5 6 7 7 6 5 4 3 0 2 2 21 21 21 21 17 17 21 21 21 21 21 21 21 21 21 21 21 9
9 3 4 5 6 7 7 6 5 4 3 2 2 2 21 21 21 9 21 21 8 15 15 8 8 8 8 21 21 21 21 9
9 19 19 5 6 6 6 6 5 4 3 2 2 21 21 21 21 21 21 21 8 17 17 17 17 17 8 21 21 21 21 9
9 19 19 5 5 5 5 5 5 4 3 2 0 21 21 21 21 21 21 21 8 17 17 17 17 17 8 21 21 21 21 9
9 19 19 4 4 4 4 4 4 4 3 9 21 21 21 9 9 21 21 21 8 17 17 17 17 17 8 21 21 21 21 9
9 19 19 19 19 3 3 3 3 3 3 21 21 21 21 9 9 21 21 21 8 8 8 8 8 8 8 21 9 9 21 9
9 19 19 19 19 19 19 2 2 2 21 21 21 21 21 21 21 21 21 21 9 21 21 21 21 21 9 21 9 9 21 9
9 19 19 19 19 19 19 19 21 21 21 21 21 21 21 21 21 21 9 21 21 21 21 21 21 21 21 21 21 21 21 9
9 9 9 9 9 9 9 9 9 9 9 9 9 9 9 9 9 9 9 9 9 9 9 9 9 9 9 9 9 9 9 9
