8 8 8 8 8 0 0 0 0 0 0 9 9 9 9 9 9 9 0 0 0 0 0 0 0 0 0 0 0 9 9 9
8 17 17 17 8 0 0 0 0 9 9 9 9 9 0 0 9 9 9 0 0 0 9 0 0 0 0 0 0 9 9 9
8 17 17 17 8 0 0 0 0 9 9 9 9 9 0 0 0 9 9 0 0 9 0 0 0 0 0 0 0 9 9 9
8 17 17 17 8 0 0 0 0 9 9 0 9 9 0 0 0 9 9 0 9 0 0 0 8 8 0 0 0 9 9 9
8 8 16 8 8 0 0 0 9 9 0 0 0 9 9 0 0 0 9 0 0 0 0 0 8 17 8 0 0 0 9 0
0 0 0 0 0 0 0 0 9 9 0 0 0 9 9 9 9 0 0 0 0 0 0 8 17 17 17 8 0 0 0 0
0 0 0 0 0 0 0 0 9 9 0 0 0 0 9 9 9 9 0 0 0 0 8 17 17 8 8 0 0 0 0 0
0 0 0 0 0 0 0 0 9 9 9 0 0 0 9 9 9 0 0 0 0 8 17 17 8 0 0 0 0 0 0 0
0 0 0 0 0 0 0 9 9 9 9 0 0 0 0 9 0 0 0 0 8 17 17 17 8 0 0 9 9 9 9 0
0 0 0 0 0 0 9 9 9 9 9 9 0 0 0 0 0 0 9 0 8 17 17 17 8 0 0 0 0 0 9 0
0 0 0 0 9 9 9 0 0 9 9 0 0 0 0 9 0 0 0 0 8 17 17 17 8 0 0 0 0 0 0 0
0 0 0 9 9 9 9 0 0 0 9 9 0 0 9 9 9 0 9 0 8 17 17 17 8 0 0 0 0 0 9 0
0 0 0 0 9 9 9 9 0 0 9 0 0 9 9 9 0 0 0 0 8 17 17 17 8 0 0 9 9 0 0 0
0 0 0 0 0 0 0 9 9 0 0 0 0 9 9 9 0 0 0 0 8 17 17 17 8 0 0 9 9 0 0 0
8 15 8 8 0 0 0 9 9 9 0 0 0 0 9 9 0 9 9 0 8 17 17 8 0 0 0 9 9 0 0 0
8 17 17 8 0 0 9 9 9 0 0 0 0 9 9 0 0 0 0 0 8 17 17 8 0 0 9 9 9 9 0 0
8 17 17 8 0 0 9 9 0 0 9 9 9 9 0 0 0 0 0 0 8 16 16 8 21 0 9 9 9 0 0 0
8 17 17 8 0 0 0 0 0 0 9 9 9 9 9 9 0 21 21 21 21 21 21 21 21 0 9 9 9 0 0 0
8 17 17 15 0 0 0 0 0 9 9 9 9 9 9 9 21 21 10 10 10 21 21 21 9 0 0 0 0 0 0 0
8 8 15 15 0 0 0 9 9 9 9 0 9 9 9 21 21 21 10 10 10 10 21 0 9 0 0 0 0 0 0 0
0 0 0 0 0 0 9 9 9 9 0 0 0 0 0 0 21 21 10 10 10 8 8 21 0 0 0 0 0 0 0 0
0 0 0 0 0 9 9 9 9 0 0 0 0 0 0 0 9 21 21 10 10 10 10 21 0 9 0 0 9 9 9 9
9 9 0 0 0 9 9 9 9 0 0 0 0 0 0 9 9 0 21 10 10 10 10 21 21 21 0 0 0 0 0 0
9 9 9 0 0 0 9 9 9 9 0 0 0 0 9 9 9 0 21 21 21 21 21 21 21 0 0 0 9 0 0 0
9 9 9 0 0 0 9 0 9 9 0 0 0 0 9 9 9 9 0 0 8 8 8 8 0 0 9 0 9 0 0 0
9 9 9 9 0 0 0 0 9 9 9 0 0 0 0 9 9 9 9 9 8 8 8 8 8 0 0 0 0 0 0 0
9 9 9 0 0 0 0 0 9 9 9 0 0 0 0 9 9 9 9 9 9 8 8 8 8 0 0 8 8 15 8 8
0 0 0 0 0 9 0 0 0 9 0 0 0 0 0 0 0 0 9 9 9 9 8 8 0 0 0 8 17 17 17 8
0 0 0 0 9 0 0 0 0 0 0 0 0 0 0 0 0 0 0 9 9 9 8 0 0 0 0 8 17 17 17 8
0 0 0 0 0 0 0 0 0 0 0 0 0 0 0 0 0 0 9 9 9 9 9 0 0 0 0 8 17 17 17 8
0 0 0 0 9 0 0 0 9 9 9 0 0 0 0 0 0 0 0 9 9 9 0 0 0 0 0 8 8 8 8 8
