8 8 8 8 8 8 8 5 6 6 9 5 5 4 3 2 9 3 3 4 5 5 9 9 5 5 4 3 3 3 0 0
8 17 9 17 17 17 15 5 6 9 6 9 5 4 3 2 3 9 3 4 5 6 6 7 9 5 4 3 0 9 0 0
8 17 17 17 17 8 8 5 9 6 6 9 5 4 9 2 9 3 3 4 5 6 7 7 9 5 4 3 0 0 3 0
8 17 17 17 15 8 4 5 5 5 4 4 4 9 3 2 0 3 3 4 9 6 7 7 6 5 4 9 0 0 3 0
8 8 8 8 7 7 7 5 9 9 4 5 5 5 5 5 9 3 9 9 9 9 9 9 9 9 9 3 0 0 0 0
0 0 0 7 7 9 21 21 21 21 4 5 6 6 6 9 17 17 17 17 17 17 17 17 17 17 9 15 9 9 9 9
0 0 0 0 9 21 21 12 12 21 9 5 6 7 6 5 17 17 17 17 17 17 17 17 17 17 9 17 17 17 17 9
0 27 0 0 0 21 21 12 12 21 4 5 6 6 6 5 17 17 9 0 0 0 0 0 0 8 9 17 17 17 17 9
27 0 0 0 0 21 21 21 21 21 4 5 5 5 5 9 17 17 0 0 0 9 0 9 0 8 9 17 17 17 17 9
0 0 8 8 8 8 21 21 21 21 9 9 9 4 4 8 15 8 8 8 8 8 15 8 0 0 15 17 17 17 17 9
0 0 8 17 17 8 0 0 21 21 12 12 12 21 9 8 7 7 7 7 7 7 7 8 0 0 15 15 9 9 9 9
27 27 8 15 8 8 0 0 21 21 21 12 12 21 21 9 8 17 17 17 17 17 7 8 9 9 9 0 0 27 17 17
0 0 0 7 7 7 7 7 0 21 21 12 12 21 21 21 8 17 17 17 17 17 7 8 2 2 2 27 2 2 17 17
27 0 0 7 9 7 9 7 0 9 21 12 12 9 21 21 8 17 17 17 17 17 7 8 3 27 3 3 3 2 17 17
0 0 0 7 7 7 17 17 17 17 17 17 17 17 17 17 15 17 17 17 17 17 7 8 3 4 4 4 3 2 17 17
0 3 3 3 3 3 17 17 17 17 17 17 17 17 17 17 15 17 17 17 17 17 7 8 27 4 5 4 27 7 17 17
0 3 4 4 9 4 17 17 17 9 21 12 12 9 21 21 8 17 17 17 17 17 7 8 9 4 4 4 3 9 17 17
27 3 4 27 5 5 17 17 21 21 21 12 12 21 21 21 8 8 8 17 17 17 7 8 2 3 3 3 3 2 17 17
0 3 4 5 5 6 17 21 10 10 21 21 12 12 21 21 21 21 8 7 7 7 7 8 2 2 8 15 8 8 8 8
9 3 4 5 6 6 17 21 10 10 21 21 12 12 21 21 21 21 8 7 7 7 7 8 27 0 8 17 17 17 17 8
9 9 4 5 9 6 17 21 21 10 21 21 12 12 12 21 21 21 8 8 8 8 15 8 5 5 8 17 9 17 17 8
0 0 9 0 0 0 17 17 17 21 6 21 21 12 12 12 21 21 9 7 7 4 5 6 6 6 8 17 17 9 9 8
0 0 0 0 0 0 17 17 17 6 7 6 21 21 12 12 12 21 9 7 9 9 5 9 9 7 8 17 17 17 17 8
0 8 8 8 8 8 9 17 17 9 6 6 5 21 21 12 12 12 9 7 7 7 5 6 7 7 8 9 17 17 17 8
0 8 17 17 17 8 17 17 17 17 17 17 17 17 17 21 21 12 9 7 7 9 5 6 27 7 8 17 17 9 17 8
0 8 17 17 17 8 17 17 17 17 17 8 17 17 17 21 21 21 17 17 7 7 27 6 6 6 15 17 17 17 17 8
0 15 17 17 17 8 0 0 0 0 0 0 9 17 17 0 0 9 17 17 7 9 5 27 5 5 15 15 8 8 8 8
0 8 8 17 17 8 8 15 8 7 0 27 0 17 17 9 0 0 17 17 9 9 4 4 9 4 17 17 7 7 7 7
0 0 8 8 17 17 17 17 8 7 0 0 0 17 17 9 9 9 17 17 3 3 3 3 3 3 17 17 7 7 7 7
0 0 0 8 17 17 17 17 8 7 0 9 9 17 17 17 17 17 17 17 17 17 17 17 17 17 17 17 7 7 7 7
0 0 0 0 8 8 8 8 8 7 0 0 0 17 17 17 17 17 17 17 17 17 17 17 17 17 17 17 7 7 7 7
0 0 0 0 0 0 0 0 0 0 14 0 0 9 9 9 0 0 0 0 0 0 0 0 9 7 7 7 7 9 9 7
