0 0 0 0 0 0 0 0 0 0 0 0 0 0 0 0 0 0 0 0 0 0 0 0 0 0 0 0 0 0 0 0 0 0 0 0 0 21 21 21 0 0 0 0 0 0 0 0 0 0 0 0 0 0 0 0 0 0 0 0 0 0 0 0 0 0 0 0 0 0 0 0 0 0 0 0 0 0 0 0 0 8 8 8 8 8 8 8 8 8 8 8 8 8 8 8 8 8 8 8
0 0 0 0 0 0 0 0 0 0 0 0 0 0 0 0 0 0 0 0 0 0 0 0 0 0 0 0 0 0 0 0 0 0 0 0 0 21 11 21 0 0 0 0 0 0 0 0 0 0 0 27 0 0 0 0 0 0 0 0 0 0 0 0 0 0 0 0 0 0 0 0 0 0 0 0 0 0 0 0 0 8 14 14 14 14 14 8 14 14 14 14 14 14 8 14 14 14 14 8
0 0 0 0 0 0 0 0 0 0 0 0 0 0 0 0 0 0 0 0 0 0 0 0 0 0 0 0 0 0 0 0 0 0 0 0 21 11 11 21 21 21 0 0 0 0 0 0 0 0 0 0 0 27 0 0 0 0 0 0 0 0 27 0 27 0 0 0 27 0 0 0 0 27 0 0 27 0 0 0 0 8 14 14 14 14 14 14 14 14 14 14 14 14 14 14 14 14 14 8
0 0 0 0 0 0 0 0 0 0 0 0 0 0 0 0 0 0 0 0 0 0 0 0 0 0 0 0 0 0 0 0 0 0 0 0 21 11 11 11 21 21 0 0 0 0 0 0 0 0 0 0 0 0 0 0 19 19 0 0 27 0 0 0 0 0 0 0 0 27 0 0 0 0 0 0 0 0 0 27 0 8 14 14 14 14 14 14 14 14 14 14 14 14 14 14 14 14 14 8
0 0 0 0 0 0 0 0 0 0 0 0 0 0 0 0 0 0 0 0 0 0 0 0 0 0 0 0 0 0 0 0 0 0 0 0 21 21 11 11 11 21 0 0 0 0 0 0 0 0 27 0 0 0 0 0 19 19 0 0 0 0 0 0 0 0 27 0 0 27 0 0 0 0 27 0 0 27 0 0 0 8 8 8 8 8 8 8 17 17 8 8 8 8 8 8 8 8 8 8
0 0 0 0 0 0 0 0 0 0 0 0 0 0 0 0 0 0 0 0 0 0 0 0 0 0 0 0 0 0 0 0 0 0 0 0 21 21 11 11 11 21 0 0 0 0 0 0 0 0 0 0 0 27 0 0 19 19 0 0 0 27 0 27 27 0 0 0 0 0 0 27 0 0 0 0 0 0 0 0 0 8 3 3 3 3 3 8 14 14 14 14 14 14 14 14 14 14 14 8
0 0 0 0 0 0 0 0 0 0 0 0 0 0 0 0 0 0 0 0 0 0 0 0 0 0 0 0 0 0 0 0 0 0 0 21 21 11 11 11 21 21 0 0 0 27 0 27 0 0 0 0 27 0 0 0 19 19 0 27 0 0 0 27 0 27 0 27 0 0 0 0 0 0 27 0 0 27 0 0 0 8 3 3 3 3 3 8 14 14 14 14 14 14 14 14 14 14 14 8
0 0 0 0 0 0 0 0 0 0 0 0 0 0 0 0 0 0 0 0 0 0 0 0 0 0 0 0 0 0 0 0 0 0 0 21 11 11 11 11 21 21 0 0 0 0 0 0 0 0 0 0 0 0 0 0 19 19 0 0 0 0 0 27 0 0 0 27 0 27 0 0 0 0 0 0 0 0 0 0 0 8 4 4 4 4 4 8 14 14 14 14 14 14 14 14 14 14 14 8
0 0 0 0 0 0 0 0 0 0 0 0 0 0 0 0 0 0 0 0 0 0 0 0 0 0 0 0 0 0 0 0 0 0 0 21 21 11 11 11 21 21 0 0 0 0 27 0 0 27 0 0 0 0 0 27 19 19 0 0 27 0 0 0 0 0 0 0 0 0 0 27 0 27 0 0 0 0 27 0 27 8 4 4 4 4 4 8 8 8 8 8 8 8 8 8 8 14 14 8
0 0 0 0 0 0 0 0 0 0 0 0 0 0 0 0 0 0 0 0 0 0 0 0 0 0 0 0 0 0 0 0 0 0 0 21 11 11 11 11 21 21 0 0 27 0 0 0 0 0 0 0 27 0 0 0 19 19 0 0 0 0 27 0 0 27 0 0 0 27 0 0 0 0 0 0 27 0 0 0 0 8 5 5 5 5 4 17 14 14 14 14 14 14 14 14 8 14 14 8
0 0 0 0 0 0 0 0 0 0 0 0 0 0 0 0 0 0 0 0 0 0 0 0 0 0 0 0 0 0 0 0 0 0 0 21 21 11 11 11 21 21 0 0 0 0 0 27 0 0 0 27 0 0 27 0 19 19 0 0 0 0 0 0 0 0 0 0 0 0 0 0 0 27 0 0 0 0 0 0 0 8 6 6 6 5 5 17 14 14 14 14 14 14 14 14 8 14 14 8
0 0 0 0 0 0 0 0 0 0 0 0 0 0 0 0 0 0 0 0 0 0 0 0 0 0 0 0 0 0 0 0 0 0 21 21 11 11 12 11 11 21 0 0 0 0 0 0 0 0 27 0 27 0 0 0 19 19 19 19 19 19 19 19 19 19 19 19 19 19 19 19 19 19 19 19 19 19 19 19 19 17 7 7 6 6 6 8 8 8 8 8 8 8 8 8 8 17 17 8
0 0 0 0 0 0 0 0 0 0 0 0 0 0 0 0 0 0 0 0 0 0 0 0 0 0 0 0 0 0 0 0 0 0 21 11 11 12 12 12 11 21 0 0 27 0 0 27 0 0 0 0 0 0 0 0 19 19 19 19 19 19 19 19 19 19 19 19 19 19 19 19 19 19 19 19 19 19 19 19 19 17 7 7 7 7 7 17 14 14 14 14 14 14 14 14 14 14 14 8
0 0 0 0 0 0 0 0 0 0 0 0 0 0 0 0 0 0 0 0 0 0 0 0 0 0 0 0 0 0 0 0 0 0 21 11 11 12 12 11 11 21 0 0 27 0 27 0 0 27 0 0 0 0 0 0 19 19 0 0 0 0 0 0 24 0 0 0 24 0 0 0 24 0 27 0 0 24 0 0 0 8 6 7 7 7 7 17 14 14 14 14 14 14 14 14 14 14 14 8
0 0 0 0 0 0 0 0 0 0 0 0 0 0 0 0 0 0 0 0 0 0 0 0 0 0 0 0 0 0 0 0 0 0 21 11 11 12 12 11 11 21 0 0 0 0 0 27 0 0 0 0 0 27 0 0 19 19 0 24 24 27 0 0 24 0 27 0 0 24 0 27 0 24 0 0 24 27 0 27 0 8 6 6 6 6 6 8 8 8 8 8 8 8 8 8 8 17 17 8
0 0 0 0 0 0 0 0 0 0 0 0 0 0 0 0 0 0 0 0 0 0 0 0 0 0 0 0 0 0 0 0 0 0 21 11 11 12 12 11 21 21 0 0 0 27 0 0 0 0 0 27 0 27 0 0 19 19 0 0 24 0 27 0 27 0 24 0 27 0 0 0 27 0 27 0 0 27 0 0 0 8 5 5 5 5 5 8 14 14 14 14 14 14 14 14 8 14 14 8
0 0 0 0 0 0 0 0 0 0 0 0 0 0 0 0 0 0 0 0 0 0 0 0 0 0 0 0 0 0 0 21 0 21 21 11 11 12 11 11 21 21 0 0 0 0 0 0 27 0 27 0 0 0 0 0 19 19 0 24 0 0 0 0 0 0 0 27 0 0 0 24 27 0 24 24 0 27 0 24 0 8 4 4 4 4 4 17 14 14 14 14 14 14 14 14 8 14 14 8
0 0 0 0 0 0 0 0 0 0 0 0 0 0 0 0 0 0 0 0 0 0 0 0 0 0 0 0 0 0 0 0 0 21 11 11 11 12 12 11 21 21 0 0 0 0 27 0 0 0 0 0 0 0 0 0 19 19 0 27 0 27 0 0 27 0 0 0 27 27 24 0 0 0 27 0 0 0 0 0 0 8 4 4 4 4 4 17 14 14 14 14 14 14 14 14 8 14 14 8
0 0 0 0 0 0 0 0 0 0 0 0 0 0 0 0 0 0 0 0 0 0 0 0 0 0 0 0 0 0 0 0 0 21 11 11 11 12 11 11 11 21 0 0 27 0 0 0 0 27 0 0 0 0 0 0 19 19 0 0 0 0 0 0 0 0 0 27 0 0 0 0 0 24 0 0 27 0 24 27 0 8 3 3 3 3 3 8 14 14 14 14 14 14 14 14 8 14 14 8
0 0 0 0 0 0 0 0 0 0 0 0 0 0 0 0 0 0 0 0 0 0 0 0 0 0 0 0 0 0 0 0 0 21 21 11 11 12 12 11 21 21 0 0 0 0 27 0 0 0 0 0 27 27 0 0 19 19 0 27 24 24 0 27 0 0 27 0 0 0 27 0 24 24 0 0 0 0 0 0 0 8 8 8 8 8 8 8 8 8 8 8 8 8 8 8 8 14 14 8
0 0 0 0 0 0 0 0 0 0 0 0 0 0 0 0 0 0 0 0 0 0 0 0 0 0 0 0 0 0 0 0 0 21 11 11 12 12 11 21 21 0 0 0 0 0 0 0 0 0 0 0 0 0 0 0 19 19 0 0 0 0 0 0 0 0 0 0 24 0 27 0 0 0 0 27 0 27 0 27 0 8 14 14 14 14 14 14 14 14 14 14 14 14 14 14 14 14 14 8
0 0 0 0 0 0 0 0 0 0 0 0 0 0 0 0 0 0 0 0 0 0 0 0 0 0 0 0 0 0 0 0 0 0 21 11 12 12 12 11 21 21 21 0 0 0 0 0 27 0 0 0 0 0 0 0 19 19 0 0 27 0 27 0 27 27 0 27 0 24 0 0 0 27 0 24 0 0 27 0 0 8 14 14 14 14 14 14 14 14 14 14 14 14 14 14 14 14 14 8
0 0 0 0 0 0 0 0 0 0 0 0 0 0 0 0 0 0 0 0 0 0 0 0 0 0 0 0 0 0 0 0 0 0 21 11 12 12 11 11 21 11 21 0 0 27 0 0 0 0 0 27 0 27 0 0 19 19 0 27 0 0 0 0 27 0 0 0 27 0 0 27 0 0 0 0 27 0 0 0 27 8 8 8 8 8 8 8 8 8 17 17 8 8 8 8 8 8 8 8
0 0 0 0 0 0 0 0 0 0 0 0 0 0 0 0 0 0 0 0 0 0 0 0 0 0 0 0 0 0 0 0 0 21 21 12 12 12 11 21 21 21 21 0 0 0 0 0 0 0 0 0 0 0 27 0 19 19 0 0 0 27 0 24 0 0 27 0 0 0 27 0 0 27 0 0 0 0 0 0 0 8 14 14 14 17 14 14 8 2 2 2 8 14 14 14 14 14 14 8
0 0 0 0 0 0 0 0 0 0 0 0 0 0 0 0 0 0 0 0 0 0 0 0 0 0 0 0 0 0 0 0 21 21 11 11 12 12 11 21 0 0 0 0 0 0 0 0 0 27 0 0 0 0 0 0 19 19 24 0 24 24 0 0 27 27 24 0 27 0 0 0 27 0 27 27 0 0 27 0 0 8 14 14 14 17 14 14 8 3 3 3 8 14 14 14 14 14 14 8
0 0 0 0 0 0 0 0 0 0 0 0 0 0 0 0 0 0 0 0 0 0 0 0 0 0 0 0 0 0 0 0 21 11 11 12 12 12 12 21 0 0 0 27 0 0 0 0 0 0 0 0 0 0 0 0 19 19 0 0 0 27 0 0 24 0 0 0 0 0 0 0 0 27 0 0 0 0 0 27 0 8 14 14 14 8 14 14 8 3 3 3 17 14 14 14 14 14 14 8
0 0 0 0 0 0 0 0 0 0 0 0 0 0 0 0 0 0 0 0 0 0 0 0 0 0 0 0 0 0 0 21 11 11 11 12 12 12 12 21 0 0 0 0 0 27 0 27 27 0 0 0 27 0 0 0 19 19 0 27 0 27 0 0 0 0 27 0 0 0 27 27 0 27 0 0 27 27 27 0 0 8 14 14 14 8 14 14 8 4 4 4 17 14 14 14 14 14 14 8
0 0 0 0 0 0 0 0 0 0 0 0 0 0 0 0 0 0 0 0 0 0 0 0 0 0 0 0 0 0 21 21 21 21 11 12 12 11 21 21 0 0 0 0 0 0 0 0 0 0 0 0 0 0 0 0 19 19 0 0 0 0 0 0 27 0 0 0 0 27 0 27 0 0 0 0 0 0 0 0 0 8 14 14 14 8 14 14 8 5 5 5 8 14 14 14 14 14 14 8
0 0 0 0 0 0 0 0 0 0 0 0 0 0 0 0 21 21 21 0 0 0 0 0 0 0 0 0 0 0 0 21 11 11 10 12 12 11 11 21 0 0 27 0 0 0 0 27 0 0 0 0 0 0 0 27 19 19 0 0 0 0 0 0 0 0 0 0 0 0 27 27 0 0 0 0 0 27 27 0 0 8 8 8 8 8 17 17 8 6 6 5 8 8 8 8 8 8 8 8
0 0 0 0 0 0 0 0 0 0 0 0 0 0 0 0 21 10 21 0 0 0 0 0 0 0 0 0 0 0 0 21 11 13 10 12 13 13 11 21 21 0 0 0 0 0 0 0 0 0 27 0 0 27 0 0 19 19 0 0 27 0 27 0 27 0 0 0 0 0 0 0 0 27 0 0 0 27 0 0 0 17 3 4 5 6 7 7 7 7 6 5 8 14 14 14 14 14 14 8
0 0 0 0 0 0 0 0 0 0 0 0 0 0 0 0 21 21 21 0 0 0 0 0 0 0 0 0 0 0 0 21 11 11 12 12 12 11 11 11 11 21 0 0 0 27 0 0 0 0 0 0 0 0 0 0 19 19 0 0 0 0 27 0 27 0 0 0 27 0 0 0 0 0 0 27 0 0 0 27 0 17 3 4 5 6 6 7 7 7 6 5 17 14 14 14 14 14 14 8
0 0 0 0 0 0 0 0 0 0 0 0 0 0 0 0 21 21 21 0 0 0 0 0 0 0 0 0 0 0 0 21 21 11 12 12 12 11 11 21 21 21 0 0 0 0 0 0 27 0 0 27 0 0 8 7 17 17 7 8 0 0 0 0 0 0 0 0 0 24 0 27 0 0 27 0 0 0 0 0 0 8 3 4 5 6 6 6 7 7 6 5 17 14 14 14 14 14 14 8
0 0 0 0 0 0 0 0 0 0 0 0 0 0 0 0 21 10 21 0 0 0 0 0 0 0 0 0 0 0 21 21 11 11 12 12 12 11 21 21 0 0 0 0 0 0 0 0 0 27 0 0 0 0 8 7 17 17 7 8 0 0 27 27 0 27 0 0 0 24 0 0 27 0 24 0 0 0 27 0 0 8 3 4 5 5 5 6 6 6 6 5 8 8 8 8 8 8 8 8
0 0 0 0 0 0 0 0 0 0 0 0 0 0 0 0 21 21 21 0 0 0 0 0 0 0 0 0 0 0 21 11 11 12 12 12 12 21 11 21 0 0 0 0 27 0 0 0 0 0 27 0 0 0 8 7 17 17 7 8 27 0 0 0 0 27 0 27 0 0 0 27 0 0 0 0 27 0 0 0 0 8 3 4 4 4 4 5 5 5 5 5 8 14 14 14 14 14 14 8
0 0 0 0 0 0 0 0 0 0 0 0 0 0 0 0 0 0 0 0 0 0 0 0 0 0 0 0 0 0 0 21 21 11 11 12 12 21 21 21 0 0 0 0 0 0 0 0 0 0 27 27 0 0 8 7 17 17 7 8 0 24 24 0 0 0 27 0 0 27 0 0 0 24 0 0 0 0 0 27 0 8 8 8 8 8 8 8 4 4 4 4 8 14 14 14 14 14 14 8
0 0 0 0 0 0 0 0 0 0 0 0 0 0 0 0 0 0 0 0 0 0 0 0 0 0 0 0 0 21 21 21 21 11 11 12 12 21 21 21 0 0 0 0 0 27 0 0 0 0 0 0 0 0 8 7 17 17 7 8 0 0 24 27 27 0 0 0 0 0 0 0 0 0 27 27 27 0 27 0 0 8 14 14 14 14 14 8 3 3 3 3 8 14 14 14 14 14 14 8
0 0 0 0 0 0 0 0 0 0 0 0 0 0 0 0 0 0 0 0 0 0 0 0 0 0 0 0 0 21 21 21 21 21 11 12 11 11 11 21 0 0 27 0 0 0 0 0 0 0 0 0 0 0 8 7 17 17 7 8 24 0 27 27 0 0 0 27 0 27 0 27 27 0 0 27 0 0 24 24 0 8 14 14 14 14 14 17 7 7 7 7 17 14 14 14 14 14 14 8
0 0 0 0 0 0 0 0 0 0 0 0 0 0 0 0 0 0 0 0 0 0 0 0 0 0 0 0 0 0 21 21 21 11 11 12 11 11 21 0 0 0 0 0 0 0 0 0 0 0 0 0 0 0 8 7 17 17 7 8 0 0 0 24 0 0 0 0 0 0 0 0 0 0 0 0 0 24 0 0 0 8 14 14 14 14 14 17 7 7 7 7 17 14 14 14 14 14 14 8
0 0 0 0 0 0 0 0 0 0 8 8 8 8 8 8 8 8 8 8 8 8 8 8 8 8 8 8 8 8 8 8 8 8 8 8 8 8 8 8 8 8 8 8 8 8 8 8 8 8 8 8 8 8 8 7 17 17 7 8 8 8 8 8 8 8 8 8 8 8 8 8 8 8 8 8 8 8 8 8 8 8 8 8 8 8 8 8 8 8 8 8 8 8 8 8 8 8 8 8
0 0 0 0 0 0 0 0 0 0 8 7 7 7 7 7 7 7 7 7 7 7 7 7 7 7 7 7 7 7 7 21 21 21 21 12 11 21 21 7 7 7 7 7 7 7 7 7 7 7 7 7 7 7 7 9 17 17 9 7 7 7 7 7 7 7 7 7 7 7 7 7 7 7 7 7 7 7 7 7 7 7 7 7 7 7 7 7 7 7 7 7 7 7 7 7 7 7 7 7
0 0 0 0 0 0 0 0 0 0 17 17 17 17 17 17 17 17 17 17 17 17 17 17 17 17 17 17 17 17 17 17 17 17 17 17 17 17 17 17 17 17 17 17 17 17 17 17 17 17 17 17 17 17 17 17 17 17 17 17 20 19 19 20 20 19 20 17 19 20 19 19 20 19 20 20 19 19 20 20 20 20 20 19 19 19 19 19 20 20 20 19 19 20 19 19 20 19 19 20
0 0 0 0 0 0 0 0 0 0 17 17 17 17 17 17 17 17 17 17 17 17 17 17 17 17 17 17 17 17 17 17 17 17 17 17 17 17 17 17 17 17 17 17 17 17 17 17 17 17 17 17 17 17 17 17 17 17 17 17 20 19 17 20 20 20 20 20 20 20 20 19 19 19 20 20 20 19 19 19 19 19 19 20 20 20 20 20 19 19 20 20 19 19 19 19 20 19 20 19
0 0 0 0 0 0 0 0 0 0 9 7 7 7 7 7 7 7 7 7 7 7 7 7 7 7 7 7 7 7 7 7 7 21 21 12 11 11 11 11 11 11 11 11 11 11 11 11 11 11 11 11 11 11 11 9 17 17 9 11 11 11 11 11 11 11 11 11 11 11 11 11 11 11 0 0 0 0 0 0 0 0 0 0 0 0 0 0 0 0 19 20 0 0 0 0 0 0 0 0
0 0 0 0 0 0 0 0 0 0 9 9 9 9 9 9 9 9 9 9 9 9 9 9 9 9 9 9 9 9 9 9 9 9 9 9 9 9 9 9 9 9 9 9 9 9 9 9 9 9 9 9 9 9 9 9 17 17 9 9 9 9 9 9 9 9 9 9 9 9 9 9 9 11 0 0 3 0 0 0 0 0 0 0 3 0 0 0 0 0 19 20 0 0 0 0 0 0 0 0
0 0 0 0 0 0 0 0 0 0 0 0 0 0 0 0 0 0 0 0 0 0 0 0 0 0 0 0 0 0 0 0 0 21 10 12 11 21 3 3 0 3 0 3 3 8 8 8 8 8 8 8 8 8 9 3 17 17 0 3 3 0 3 0 3 0 3 0 0 3 0 0 9 11 0 0 0 0 0 0 3 0 0 3 0 0 3 0 0 0 19 20 0 0 0 0 0 0 0 0
0 0 0 0 0 0 0 0 0 0 0 0 0 0 0 0 0 0 0 0 0 0 0 0 0 0 0 0 0 0 0 0 0 21 10 12 11 3 3 3 0 0 0 0 0 8 14 14 14 14 14 14 14 8 9 3 17 17 3 3 3 3 3 3 3 0 0 3 3 3 3 3 9 11 0 3 0 3 0 3 3 3 0 0 0 24 3 0 0 0 20 20 0 0 0 0 0 0 0 0
0 0 0 0 0 0 0 0 0 0 0 0 0 0 0 0 0 0 0 0 0 0 0 0 0 0 0 0 0 0 0 0 0 21 10 12 11 3 0 3 0 24 0 3 3 8 14 14 14 14 14 14 14 8 9 3 17 17 0 3 24 24 3 0 3 0 3 3 0 0 27 0 9 11 0 3 0 3 0 3 0 0 0 3 0 3 0 3 0 0 20 20 0 0 0 0 0 0 3 0
0 0 0 0 0 0 0 0 0 0 0 0 0 0 0 0 0 0 0 0 0 0 0 0 0 0 0 0 0 0 0 17 17 17 17 17 17 17 17 17 0 0 3 0 0 17 14 14 14 14 14 14 14 8 9 3 17 17 0 24 3 4 0 0 3 4 27 3 3 3 0 0 9 11 0 0 3 27 0 3 3 0 3 3 0 0 24 0 0 0 19 19 0 3 0 3 3 0 0 0
0 0 0 0 0 0 0 0 0 0 0 0 0 0 0 0 0 0 0 0 0 0 0 0 0 0 0 0 0 0 0 17 17 17 17 17 17 17 17 17 3 3 3 24 0 17 14 14 14 14 14 14 14 8 9 3 17 17 3 3 5 4 7 5 3 27 3 3 27 0 0 3 9 11 0 6 5 27 27 0 0 27 0 3 27 3 24 3 0 0 19 19 0 3 3 0 0 0 3 0
0 0 0 0 0 0 0 0 0 0 0 0 0 0 0 0 0 0 0 0 0 0 0 0 0 0 0 0 0 0 0 0 0 21 10 12 11 5 5 3 24 0 3 3 3 17 14 14 14 14 14 14 14 8 9 3 17 17 0 3 3 4 27 0 4 3 3 3 0 3 3 0 9 11 0 6 0 5 5 0 0 27 0 0 3 0 3 0 3 0 19 19 0 0 0 27 0 27 3 0
0 0 0 0 0 0 0 0 0 0 0 0 0 0 0 0 0 0 0 0 0 0 0 0 0 0 0 0 0 0 0 0 0 21 10 12 11 5 5 5 5 5 3 3 3 17 14 14 14 14 14 14 14 8 9 3 17 17 3 4 4 4 4 4 0 4 4 4 3 0 7 0 9 11 5 27 5 5 5 5 0 0 0 27 3 3 0 3 3 0 19 19 27 0 0 0 0 27 0 3
0 0 0 0 0 0 0 0 0 0 0 0 0 0 0 0 0 0 0 0 0 0 0 0 0 0 0 0 0 0 0 0 0 21 10 12 11 5 3 5 5 5 3 3 3 8 14 14 14 14 14 14 14 8 9 3 17 17 4 4 3 0 4 4 4 0 4 4 4 24 4 0 9 11 5 5 27 5 6 6 5 0 0 0 0 0 0 3 3 0 19 19 3 3 3 0 0 27 0 0
0 0 0 0 0 0 0 0 0 0 0 0 0 0 0 0 0 0 0 0 0 0 0 0 0 0 0 0 0 0 0 0 0 21 10 12 11 5 3 3 3 24 3 24 3 8 14 14 14 14 14 14 14 8 9 3 17 17 0 24 4 27 4 6 4 4 27 4 0 0 0 7 9 11 7 5 4 27 5 5 6 5 5 7 0 3 27 0 0 0 19 19 24 24 0 3 0 0 0 3
0 0 0 0 0 0 0 0 0 0 0 0 0 0 0 0 0 0 0 0 0 0 0 0 0 0 0 0 0 0 0 0 21 21 10 12 11 5 3 3 3 3 3 3 3 8 14 14 14 14 14 14 14 8 9 3 17 17 4 0 3 6 6 6 3 27 6 6 6 6 5 6 9 11 5 5 5 4 0 5 27 6 5 3 0 3 0 0 0 3 3 3 3 3 27 0 3 0 3 0
0 0 0 0 0 0 0 0 0 0 0 0 0 0 0 0 0 0 0 0 0 0 0 0 0 0 0 0 0 0 21 21 21 21 10 12 11 5 7 7 7 7 7 7 7 8 8 8 8 8 8 8 8 8 9 3 17 17 4 0 5 6 0 6 0 6 0 27 0 5 5 3 9 11 5 5 27 5 0 6 0 6 5 3 0 3 3 27 3 3 24 3 3 3 0 3 0 27 27 3
0 0 0 0 0 0 0 0 0 0 0 0 0 0 0 0 0 0 0 0 0 0 0 0 0 21 0 0 0 21 21 21 10 10 12 12 11 9 9 9 9 9 9 9 9 9 9 9 9 9 9 9 9 9 9 3 17 17 3 5 6 5 6 0 6 3 6 6 4 4 5 5 9 11 5 5 6 0 5 0 4 7 6 5 5 0 3 3 0 3 3 4 4 0 0 0 27 0 3 0
0 0 0 0 0 0 0 0 0 0 0 0 0 0 0 0 0 0 0 0 0 21 21 21 21 21 21 21 21 21 10 10 12 12 12 11 11 9 5 6 6 6 6 6 6 6 6 6 6 6 6 5 4 4 4 7 17 17 3 5 6 6 5 3 3 3 4 0 2 2 2 4 9 11 4 0 0 27 6 4 0 7 7 6 5 27 0 3 4 0 4 0 0 4 4 3 0 3 0 0
0 0 0 0 0 0 0 0 0 0 0 0 0 0 0 0 0 0 0 0 0 21 10 10 10 10 21 21 21 10 10 12 12 12 12 11 11 9 5 6 7 7 7 7 7 7 7 7 7 7 6 5 4 4 4 4 17 17 3 4 5 4 3 8 8 8 8 8 8 8 8 8 8 11 0 4 6 3 5 0 7 7 7 7 6 6 7 5 0 4 0 4 0 4 0 0 3 3 27 3
0 0 0 0 0 0 0 0 0 0 0 0 0 0 0 0 0 0 0 0 0 21 21 10 10 10 21 21 10 10 12 12 12 10 10 11 11 9 5 6 7 8 8 8 8 8 8 8 8 7 6 5 4 4 4 4 17 17 3 5 27 4 2 8 9 9 8 8 8 8 9 9 8 11 4 4 0 3 5 6 27 0 7 7 7 7 6 6 5 4 0 27 0 0 4 0 0 3 3 27
0 0 0 0 0 0 0 0 0 0 0 0 0 0 0 0 0 0 0 0 21 21 19 19 10 10 10 10 10 12 12 12 10 10 10 11 11 9 5 6 7 17 17 17 17 17 17 17 17 7 6 5 5 5 5 5 17 17 8 8 8 4 2 8 9 14 14 14 14 14 14 9 8 11 3 6 27 5 5 27 0 4 7 7 7 24 7 24 24 0 0 0 0 0 0 27 27 3 0 3
0 0 0 0 0 0 0 0 0 0 0 0 0 0 0 0 0 0 0 21 21 21 19 10 10 10 10 12 12 12 10 10 10 21 21 11 11 9 5 6 7 17 17 17 17 17 17 17 17 7 6 6 6 6 7 7 17 17 8 9 8 5 2 8 8 14 14 14 14 14 14 8 8 11 3 0 27 5 5 0 5 0 7 7 7 6 6 6 6 27 0 0 0 4 0 0 4 3 0 0
0 0 0 0 0 0 0 0 0 0 0 0 0 0 0 0 24 21 21 21 19 19 10 10 12 12 12 12 12 12 10 10 10 21 21 11 11 9 5 6 7 17 17 17 17 17 17 17 17 19 7 7 7 7 7 19 17 17 8 8 8 9 9 8 8 14 14 14 14 14 14 8 8 11 0 1 0 1 5 5 7 4 7 7 6 6 6 6 5 27 4 4 4 4 4 4 4 3 4 0
0 0 0 0 0 0 0 0 0 0 0 0 0 0 24 21 21 19 19 19 10 10 12 12 12 12 10 10 10 10 10 10 21 21 21 11 11 9 5 6 7 17 17 17 17 17 17 17 17 8 19 19 19 19 19 8 17 17 9 9 9 9 9 9 9 14 14 14 14 14 14 8 8 11 4 6 0 3 5 0 5 27 0 7 7 7 27 6 6 5 5 4 4 4 27 4 4 4 4 4
0 0 0 0 0 0 0 0 0 0 0 21 24 21 21 19 19 19 10 10 12 12 12 12 10 10 10 21 21 21 21 21 21 17 17 17 17 17 17 17 17 17 17 17 17 17 17 17 17 17 17 17 17 17 17 17 17 17 17 17 17 17 17 17 17 14 14 14 14 14 32 8 8 11 2 3 27 3 27 27 7 7 7 7 7 7 6 6 6 5 5 5 5 4 4 4 4 4 4 4
0 0 0 0 0 0 0 0 0 0 24 21 17 17 17 17 17 17 17 17 17 17 17 17 17 17 21 21 21 21 21 21 21 17 17 17 17 17 17 17 17 17 17 17 17 17 17 17 17 17 17 17 17 17 17 17 17 17 17 17 17 17 17 17 17 14 14 14 14 14 29 8 8 11 0 0 0 4 4 4 7 7 7 7 7 7 6 6 6 5 27 5 4 4 4 4 4 4 4 4
0 0 24 0 24 0 0 0 0 0 24 19 17 17 17 17 17 17 17 17 17 17 17 17 17 17 21 21 21 21 21 21 21 21 21 11 11 9 5 6 7 17 17 17 17 17 17 17 17 8 19 19 19 19 19 8 17 17 9 9 9 9 9 9 9 14 14 14 14 14 14 8 8 11 1 27 6 6 0 4 7 7 7 7 7 7 27 6 6 5 5 5 5 27 4 4 24 4 27 4
19 19 19 19 19 19 19 19 19 19 19 19 19 10 10 10 12 12 12 12 10 19 19 19 0 24 0 0 27 0 0 27 0 0 0 11 11 9 5 6 7 17 17 17 17 17 17 17 17 19 7 7 7 7 7 19 17 17 8 8 8 9 9 8 8 14 14 14 14 14 14 8 8 11 2 19 5 4 5 24 27 0 7 5 27 7 7 27 6 6 5 5 5 5 5 5 5 5 5 5
19 19 19 19 19 19 19 19 19 19 19 10 10 10 10 12 12 12 10 10 19 19 19 0 0 0 27 0 0 0 27 0 0 27 0 11 11 9 5 6 7 17 17 17 17 17 17 17 17 7 7 7 7 7 7 7 17 17 8 9 8 5 3 8 9 14 14 14 14 14 14 9 8 11 4 6 0 6 5 0 0 7 0 7 7 7 7 7 6 6 27 6 6 6 6 6 6 6 6 6
9 8 8 8 8 8 9 8 19 19 10 10 10 12 12 12 12 10 19 19 19 19 19 0 0 0 0 27 0 0 27 0 27 27 0 11 11 9 5 6 7 17 17 17 17 17 17 17 17 7 6 6 6 6 6 6 17 17 8 8 8 3 6 8 9 9 8 8 8 8 9 9 8 11 1 24 0 0 4 0 7 0 27 7 7 7 27 7 7 4 4 4 4 4 4 4 4 4 4 4
9 26 8 8 8 26 26 26 10 10 10 12 12 12 13 13 13 10 19 19 0 0 19 19 19 0 0 27 0 27 0 27 0 0 0 11 11 9 5 6 7 17 17 17 17 17 17 17 17 7 6 5 5 5 5 5 17 17 5 6 6 6 3 8 8 8 8 8 8 8 8 8 8 11 4 4 6 27 5 4 0 5 7 7 7 7 7 7 7 4 27 5 5 5 5 5 5 5 5 5
8 9 8 26 8 26 8 8 26 12 12 12 12 13 10 10 10 19 19 19 0 27 0 0 0 0 0 0 0 0 0 0 0 0 0 11 11 9 5 6 7 8 8 8 8 8 8 8 8 7 6 5 4 4 4 5 17 17 5 4 4 5 3 3 3 3 3 3 3 4 0 0 9 11 27 6 4 6 5 27 5 27 0 7 7 27 7 7 4 4 5 5 27 6 6 6 6 5 5 5
8 9 8 26 9 26 8 26 8 26 12 12 13 13 10 10 19 19 19 19 0 0 27 0 0 0 0 27 27 0 27 0 0 0 0 11 11 9 5 6 7 7 7 7 7 7 7 7 7 7 6 5 4 3 4 5 17 17 5 5 0 4 5 5 0 5 4 3 0 4 3 0 9 11 0 0 0 5 5 0 5 4 24 7 0 7 7 4 4 5 5 5 6 6 6 6 6 6 6 6
9 8 8 26 26 8 9 9 26 26 22 22 10 19 19 19 19 19 19 19 0 27 0 0 0 0 0 0 0 0 27 0 0 0 0 11 11 9 5 6 6 6 6 6 6 6 6 6 6 6 6 5 4 4 4 5 17 17 6 5 5 0 0 4 6 5 0 4 4 6 0 4 9 11 4 27 0 0 0 4 7 4 4 7 27 0 0 4 5 5 5 6 27 6 6 6 6 6 6 6
9 8 8 26 26 9 9 8 26 26 22 22 19 19 19 19 19 19 19 19 0 27 0 0 27 0 27 0 0 0 0 0 27 27 0 11 11 9 9 9 9 9 5 5 5 5 5 5 5 5 5 5 5 5 5 5 17 17 6 5 0 27 5 0 0 6 27 5 5 4 5 27 9 11 5 24 4 4 4 0 27 5 4 0 0 0 27 4 5 5 6 6 6 7 7 7 7 7 7 7
9 8 8 26 26 26 26 26 26 26 26 22 19 19 19 19 19 19 19 19 0 27 0 27 0 0 0 0 0 0 27 0 0 27 0 11 11 11 11 11 11 9 9 9 9 9 9 9 9 9 9 9 9 9 9 9 9 9 9 9 9 9 9 9 9 9 9 9 9 9 9 9 9 11 0 4 0 27 7 0 7 5 7 0 4 4 4 5 5 27 6 6 7 8 17 17 8 8 8 8
9 9 9 9 9 9 9 26 26 26 26 22 19 19 19 19 19 19 19 19 0 27 0 0 27 0 0 0 0 0 0 0 0 0 0 11 11 11 11 11 11 11 11 11 11 11 11 11 11 11 11 11 11 11 11 11 11 11 11 11 11 11 11 11 11 11 11 11 11 11 11 11 11 11 0 0 0 0 0 7 0 7 7 0 4 27 5 5 27 6 6 7 7 8 14 14 14 14 14 8
9 9 23 9 9 9 9 22 22 26 26 19 19 19 19 19 19 19 19 19 0 0 27 0 0 0 27 0 27 0 0 0 0 0 0 0 0 11 0 0 11 11 0 11 11 11 11 11 11 11 11 11 11 11 11 11 11 11 11 11 11 11 11 11 11 11 11 11 11 11 11 11 11 11 7 5 7 0 0 0 0 7 0 0 4 27 5 5 5 6 6 7 7 8 14 14 14 14 14 8
9 9 9 9 9 9 19 19 19 19 19 19 19 19 19 19 19 19 19 24 0 0 0 27 0 27 27 0 0 0 27 27 0 0 0 0 0 0 0 0 0 0 0 0 0 11 11 0 0 11 0 0 0 0 0 0 17 17 11 6 6 7 6 5 7 5 7 5 7 5 0 24 7 5 24 0 0 0 0 7 0 0 27 0 4 4 5 5 5 6 6 7 7 8 14 14 14 14 14 8
9 0 0 0 0 0 0 0 0 0 0 0 0 0 0 0 0 0 0 0 0 0 0 0 0 0 0 0 0 0 0 0 0 0 0 0 0 0 0 0 0 0 0 0 0 0 0 0 0 0 0 0 0 0 0 0 17 17 24 0 0 0 6 0 0 0 0 0 0 24 0 24 0 0 0 0 7 0 0 0 0 0 0 0 4 4 4 5 5 6 7 6 7 8 14 14 14 14 14 8
0 0 0 0 0 0 0 0 0 0 0 0 0 0 0 0 0 0 0 0 0 0 0 0 0 0 0 0 0 0 0 0 0 0 0 0 0 0 0 0 0 0 0 0 0 0 0 0 0 0 0 0 0 0 0 0 0 0 0 0 0 0 0 0 0 0 0 0 0 0 0 0 0 0 0 0 0 0 0 0 0 0 0 0 0 0 0 0 0 0 0 7 6 8 8 8 8 8 8 8
