9 9 9 9 9 9 9 9 9 9 9 9 9 9 9 9 9 9 9 9 9 9 9 9 9 9 9 9 9 9 9 9
9 0 0 0 0 0 9 9 0 0 0 0 0 3 4 5 5 5 5 5 5 4 3 15 15 27 4 5 6 7 7 9
9 0 0 0 0 0 9 9 0 0 0 0 0 3 4 5 6 6 6 6 5 4 3 15 15 3 4 5 6 7 7 9
9 0 0 0 0 0 0 0 0 0 0 0 0 3 4 5 6 7 7 6 5 4 3 15 15 3 4 5 6 6 6 9
9 0 0 0 0 0 0 0 0 0 0 0 8 8 8 15 15 15 8 8 8 4 3 15 15 3 4 5 5 5 5 9
9 9 9 9 9 27 0 0 9 9 0 0 8 17 17 17 17 17 17 17 8 3 3 15 15 3 4 4 4 4 4 9
9 0 0 0 0 0 0 0 9 9 0 0 8 17 17 17 17 17 17 17 8 0 0 15 15 3 3 3 3 3 3 9
9 0 0 0 0 0 0 0 9 9 27 0 8 17 17 17 17 17 17 17 8 0 0 15 15 8 8 16 16 8 8 9
9 0 9 9 21 21 21 0 9 9 0 0 8 17 17 9 9 9 17 17 8 0 0 15 15 8 17 17 17 17 8 9
9 0 9 9 21 10 21 0 9 9 0 0 8 17 17 12 12 12 17 17 8 0 0 15 15 8 17 17 17 17 8 9
9 2 2 2 21 21 21 0 9 9 0 0 8 17 17 12 12 12 17 17 8 0 0 15 15 8 17 17 17 17 8 9
9 2 2 2 2 2 2 0 0 0 0 0 15 17 17 17 17 17 17 17 15 0 0 15 15 8 17 17 17 17 8 9
9 3 3 3 3 3 2 0 0 0 0 0 15 17 17 17 17 17 17 17 15 0 0 15 15 8 17 17 17 17 8 9
9 4 4 4 4 9 9 9 9 9 9 0 8 17 17 17 17 17 17 17 8 0 0 15 15 8 17 17 17 17 8 9
9 4 5 5 5 9 0 0 0 0 0 0 8 17 17 17 17 17 17 17 8 0 0 15 15 8 8 16 16 8 8 9
9 4 5 6 6 9 0 0 9 9 0 0 8 17 17 17 17 17 17 17 8 0 27 15 15 6 6 17 17 6 6 9
9 4 5 6 7 9 0 27 9 9 0 0 8 8 8 15 15 15 8 8 8 0 0 15 15 7 6 17 17 6 7 9
9 4 5 6 7 9 27 0 0 0 0 27 0 8 7 17 17 17 7 8 0 0 0 15 15 15 15 17 17 15 15 9
9 4 5 6 6 9 0 0 0 0 0 0 0 8 7 17 17 17 7 8 0 0 0 15 15 15 15 17 17 15 15 9
9 4 5 5 5 9 0 0 9 9 0 0 0 8 7 17 17 17 7 8 0 0 0 9 9 0 0 17 17 0 0 9
9 4 4 4 4 9 2 0 9 9 0 0 0 8 7 17 17 17 7 8 0 9 0 9 9 0 0 17 17 0 0 9
9 3 3 3 3 3 2 0 0 0 0 0 0 8 7 17 17 17 7 8 3 9 3 3 3 3 27 17 17 9 9 9
9 2 2 2 2 2 3 3 27 9 9 9 0 8 7 17 17 17 7 8 3 4 27 4 9 4 4 17 17 0 0 9
9 9 9 9 9 9 0 27 3 3 3 3 3 8 7 17 17 17 7 8 3 4 5 5 9 5 5 17 17 0 0 9
9 17 17 17 17 9 3 3 3 9 9 9 9 8 7 17 17 17 7 8 3 4 5 6 9 6 27 17 17 9 9 9
9 17 17 17 17 9 4 4 4 9 4 4 4 17 17 17 17 17 17 17 3 9 9 7 7 6 5 17 17 0 0 9
9 17 17 17 17 9 5 5 5 9 5 9 5 17 17 17 17 17 17 17 3 27 5 6 9 6 5 17 17 0 0 9
9 17 17 17 17 9 6 6 6 6 6 6 6 17 17 17 17 17 17 17 3 4 5 5 5 5 5 17 17 9 0 9
9 17 17 17 17 9 7 7 7 7 7 7 7 17 17 17 17 17 17 17 3 4 4 4 4 0 4 17 17 0 0 9
9 17 17 17 17 17 17 17 17 17 17 17 17 17 17 17 17 17 17 17 17 17 17 17 17 17 17 17 17 9 9 9
9 17 17 17 17 17 17 17 17 17 17 17 17 17 17 17 17 17 17 17 17 17 17 17 17 17 17 17 17 9 9 9
9 9 9 9 9 9 9 9 9 9 9 9 9 9 9 9 9 9 9 9 9 9 9 9 9 9 9 9 9 9 9 9
